,Player,Nation,Pos,Squad,Age,Born,90s,Tackles Tkl,Tackles TklW,Tackles Def 3rd,Tackles Mid 3rd,Tackles Att 3rd,Vs Dribbles Tkl,Vs Dribbles Att,Vs Dribbles Tkl%,Vs Dribbles Past,Pressures Press,Pressures Succ%,Pressures Def 3rd,Pressures Mid 3rd,Pressures Att 3rd,Blocks,Sh,ShSv,Pass,Int,Tkl+Int,Clr,Er
0,Max Aarons,ENG,DF,Norwich City,21,2000,32.0,69,37,50,19,0,37,58,63.8,21,434,113,26.0,255,140,39,86,22,1,64,56,125,70
1,Che Adams,SCO,FW,Southampton,25,1996,22.7,16,9,4,6,6,2,15,13.3,13,332,87,26.2,38,132,162,25,4,0,21,10,26,15
2,Rayan Aït Nouri,FRA,DF,Wolves,20,2001,20.3,76,43,54,14,8,28,45,62.2,17,402,135,33.6,231,116,55,34,3,0,31,38,114,32
3,Kristoffer Ajer,NOR,DF,Brentford,23,1998,22.2,40,22,25,12,3,20,36,55.6,16,206,73,35.4,107,70,29,36,13,1,23,49,89,81
4,Nathan Aké,NED,DF,Manchester City,26,1995,10.3,15,5,6,8,1,4,7,57.1,3,70,23,32.9,26,37,7,12,5,0,7,18,33,31
5,Marc Albrighton,ENG,"FW,DF",Leicester City,31,1989,12.6,33,16,17,9,7,10,41,24.4,31,289,63,21.8,98,141,50,27,5,1,22,25,58,10
6,Thiago Alcántara,ESP,MF,Liverpool,30,1991,17.0,58,40,17,31,10,12,40,30.0,28,319,117,36.7,86,163,70,26,2,0,24,35,93,18
7,Trent Alexander-Arnold,ENG,DF,Liverpool,22,1998,31.7,44,24,22,15,7,23,59,39.0,36,288,97,33.7,114,88,86,39,5,1,34,76,120,43
8,Alisson,BRA,GK,Liverpool,28,1992,36.0,0,0,0,0,0,0,2,0.0,2,6,3,50.0,6,0,0,1,0,0,1,0,0,1
9,Allan,BRA,MF,Everton,30,1991,24.3,77,61,31,41,5,26,88,29.5,62,648,204,31.5,260,327,61,46,9,0,37,42,119,40
10,Dele Alli,ENG,"MF,FW",Tottenham,25,1996,7.3,19,7,11,6,2,5,17,29.4,12,209,55,26.3,81,92,36,25,5,0,20,17,36,12
11,Dele Alli,ENG,MF,Everton,25,1996,3.8,15,10,6,6,3,5,12,41.7,7,127,34,26.8,35,62,30,9,2,0,7,10,25,7
12,Miguel Almirón,PAR,"MF,FW",Newcastle Utd,27,1994,19.1,57,33,27,22,8,13,47,27.7,34,432,109,25.2,127,166,139,22,1,1,21,25,82,12
13,Marcos Alonso,ESP,DF,Chelsea,30,1990,24.1,45,28,21,13,11,14,32,43.8,18,300,85,28.3,121,101,78,39,6,0,33,66,111,55
14,Steven Alzate,COL,MF,Brighton,22,1998,4.5,9,8,3,5,1,3,5,60.0,2,79,20,25.3,30,37,12,5,1,0,4,14,23,10
15,Daniel Amartey,GHA,DF,Leicester City,26,1994,23.6,25,12,15,9,1,16,32,50.0,16,172,54,31.4,97,67,8,48,24,1,24,30,55,110
16,Joachim Andersen,DEN,DF,Crystal Palace,25,1996,32.4,36,23,26,10,0,14,28,50.0,14,157,58,36.9,95,55,7,41,21,0,20,60,96,156
17,Michail Antonio,JAM,FW,West Ham,31,1990,33.0,28,23,7,9,12,6,20,30.0,14,460,133,28.9,34,166,260,26,1,0,25,14,42,17
18,Cameron Archer,ENG,"MF,FW",Aston Villa,19,2001,0.3,0,0,0,0,0,0,0,,0,4,0,0.0,0,2,2,0,0,0,0,1,1,1
19,Alphonse Areola,FRA,GK,West Ham,28,1993,1.0,0,0,0,0,0,0,0,,0,0,0,,0,0,0,0,0,0,0,0,0,0
20,Adam Armstrong,ENG,FW,Southampton,24,1997,15.7,10,7,3,3,4,0,6,0.0,6,239,64,26.8,21,89,129,10,1,0,9,9,19,6
21,Stuart Armstrong,SCO,MF,Southampton,29,1992,16.4,26,15,14,5,7,7,29,24.1,22,266,85,32.0,76,120,70,17,1,0,16,14,40,15
22,Kepa Arrizabalaga,ESP,GK,Chelsea,26,1994,4.0,0,0,0,0,0,0,0,,0,0,0,,0,0,0,0,0,0,0,0,0,0
23,Harrison Ashby,SCO,DF,West Ham,19,2001,0.1,0,0,0,0,0,0,0,,0,0,0,,0,0,0,1,0,0,1,1,1,0
24,Pierre-Emerick Aubameyang,GAB,FW,Arsenal,32,1989,11.5,12,7,5,5,2,2,6,33.3,4,201,53,26.4,23,78,100,19,3,0,16,1,13,3
25,Jordan Ayew,GHA,FW,Crystal Palace,29,1991,22.4,52,34,19,22,11,11,22,50.0,11,515,146,28.3,121,227,167,37,4,0,33,28,80,9
26,Luke Ayling,ENG,DF,Leeds United,29,1991,25.2,79,45,50,24,5,49,101,48.5,52,392,137,34.9,215,137,40,49,28,0,21,54,133,68
27,César Azpilicueta,ESP,DF,Chelsea,31,1989,23.0,54,31,22,27,5,21,43,48.8,22,356,104,29.2,143,158,55,62,11,0,51,37,91,71
28,Daniel Bachmann,AUT,GK,Watford,27,1994,12.0,0,0,0,0,0,0,0,,0,0,0,,0,0,0,0,0,0,0,0,0,0
29,Leon Bailey,JAM,"FW,MF",Aston Villa,23,1997,8.5,19,12,7,9,3,4,13,30.8,9,145,48,33.1,24,59,62,13,2,0,11,3,22,3
30,Eric Bailly,CIV,DF,Manchester Utd,27,1994,2.4,8,3,6,2,0,1,2,50.0,1,21,9,42.9,14,6,1,5,2,0,3,8,16,10
31,Folarin Balogun,ENG,FW,Arsenal,20,2001,0.8,0,0,0,0,0,0,0,,0,21,5,23.8,2,2,17,1,0,0,1,0,0,1
32,Patrick Bamford,ENG,FW,Leeds United,27,1993,6.2,3,2,1,2,0,1,4,25.0,3,111,38,34.2,4,47,60,6,3,0,3,3,6,8
33,Shandon Baptiste,GRN,MF,Brentford,23,1998,10.1,7,4,6,0,1,3,14,21.4,11,204,68,33.3,62,94,48,15,0,0,15,21,28,11
34,Ross Barkley,ENG,MF,Chelsea,27,1993,2.0,1,1,0,1,0,0,1,0.0,1,18,3,16.7,1,10,7,1,0,0,1,2,3,0
35,Ashley Barnes,ENG,FW,Burnley,31,1989,9.0,13,10,4,6,3,2,6,33.3,4,157,35,22.3,16,84,57,6,1,1,5,6,19,4
36,Harvey Barnes,ENG,"FW,MF",Leicester City,23,1997,23.3,31,13,9,12,10,5,25,20.0,20,295,89,30.2,73,118,104,26,1,0,25,10,41,6
37,Lewis Bate,ENG,MF,Leeds United,18,2002,1.6,1,0,0,0,1,0,6,0.0,6,73,10,13.7,21,48,4,2,0,0,2,5,6,2
38,Mads Bech Sørensen,DEN,DF,Brentford,22,1999,9.3,12,7,10,2,0,5,6,83.3,1,73,29,39.7,45,22,6,10,6,0,4,9,21,28
39,Jan Bednarek,POL,DF,Southampton,25,1996,29.2,37,21,23,13,1,18,37,48.6,19,238,76,31.9,130,102,6,64,30,1,34,95,132,169
40,Donny van de Beek,NED,MF,Manchester Utd,24,1997,0.8,5,3,3,2,0,1,1,100.0,0,16,6,37.5,5,6,5,2,1,0,1,2,7,2
41,Donny van de Beek,NED,MF,Everton,24,1997,5.4,15,9,8,6,1,6,15,40.0,9,100,26,26.0,27,52,21,7,3,0,4,9,24,5
42,Asmir Begović,BIH,GK,Everton,34,1987,3.0,0,0,0,0,0,0,0,,0,0,0,,0,0,0,0,0,0,0,0,0,2
43,Saïd Benrahma,ALG,"FW,MF",West Ham,25,1995,24.1,35,23,16,13,6,16,38,42.1,22,377,94,24.9,108,187,82,22,1,0,21,12,47,7
44,Rodrigo Bentancur,URU,MF,Tottenham,24,1997,15.1,37,15,15,14,8,12,33,36.4,21,327,79,24.2,113,175,39,32,10,0,22,18,55,28
45,Christian Benteke,BEL,FW,Crystal Palace,30,1990,12.7,8,2,2,4,2,2,6,33.3,4,120,32,26.7,9,50,61,8,4,0,4,1,9,30
46,Jóhann Berg Guðmundsson,ISL,MF,Burnley,30,1990,12.2,19,9,10,7,2,9,20,45.0,11,170,44,25.9,49,69,52,18,2,0,16,17,36,21
47,Steven Bergwijn,NED,"FW,MF",Tottenham,23,1997,6.3,5,4,2,1,2,1,7,14.3,6,84,16,19.0,15,34,35,4,0,0,4,4,9,9
48,Ryan Bertrand,ENG,DF,Leicester City,31,1989,3.7,9,4,1,7,1,4,5,80.0,1,75,25,33.3,40,24,11,11,3,0,8,3,12,7
49,Mads Bidstrup,DEN,MF,Brentford,20,2001,0.5,4,2,2,2,0,0,2,0.0,2,19,8,42.1,12,7,0,1,0,0,1,1,5,2
50,Yves Bissouma,MLI,MF,Brighton,24,1996,23.5,73,50,36,34,3,18,33,54.5,15,415,149,35.9,166,201,48,43,5,0,38,55,128,51
51,Willy Boly,CIV,DF,Wolves,30,1991,10.0,27,22,19,7,1,8,15,53.3,7,110,43,39.1,64,43,3,21,7,1,14,19,46,39
52,Jarrod Bowen,ENG,FW,West Ham,24,1996,33.1,39,26,19,13,7,15,44,34.1,29,559,119,21.3,162,240,157,47,2,0,45,38,77,8
53,Jarrad Branthwaite,ENG,DF,Everton,19,2002,4.3,3,2,3,0,0,1,7,14.3,6,41,16,39.0,29,12,0,7,2,0,5,8,11,16
54,Armando Broja,ALB,FW,Southampton,19,2001,21.9,17,12,5,7,5,2,14,14.3,12,376,112,29.8,37,133,206,22,2,0,20,13,30,8
55,Josh Brownhill,ENG,MF,Burnley,25,1995,32.8,73,41,25,42,6,15,46,32.6,31,540,168,31.1,168,271,101,51,16,0,35,79,152,49
56,Lewis Brunt,ENG,MF,Leicester City,20,2000,0.3,0,0,0,0,0,0,0,,0,5,0,0.0,0,3,2,1,0,0,1,0,0,0
57,Bryan,ESP,"FW,MF",Tottenham,20,2001,1.0,4,3,2,0,2,3,6,50.0,3,38,12,31.6,10,6,22,2,0,0,2,0,4,0
58,Emi Buendía,ARG,"FW,MF",Aston Villa,24,1996,21.1,52,31,25,19,8,15,44,34.1,29,441,108,24.5,112,205,124,24,5,0,19,18,70,6
59,Dan Burn,ENG,DF,Newcastle Utd,29,1992,16.0,25,12,18,6,1,8,12,66.7,4,144,56,38.9,89,50,5,33,16,0,17,29,54,114
60,Dan Burn,ENG,DF,Brighton,29,1992,11.4,24,15,12,8,4,6,18,33.3,12,141,46,32.6,61,64,16,29,12,0,17,32,56,52
61,Jack Butland,ENG,GK,Crystal Palace,28,1993,8.5,0,0,0,0,0,0,0,,0,0,0,,0,0,0,0,0,0,0,0,0,0
62,Sam Byram,ENG,DF,Norwich City,27,1993,11.4,28,15,21,6,1,14,26,53.8,12,139,34,24.5,78,46,15,31,11,0,20,38,66,51
63,Willy Caballero,ARG,GK,Southampton,39,1981,2.0,0,0,0,0,0,0,0,,0,0,0,,0,0,0,0,0,0,0,0,0,1
64,Moisés Caicedo,ECU,MF,Brighton,19,2001,7.3,20,12,11,6,3,6,14,42.9,8,141,44,31.2,36,75,30,13,4,0,9,12,32,11
65,Dominic Calvert-Lewin,ENG,FW,Everton,24,1997,14.3,14,11,2,5,7,2,6,33.3,4,198,49,24.7,11,93,94,11,3,0,8,6,20,12
66,Chem Campbell,WAL,MF,Wolves,18,2002,0.1,1,1,0,1,0,0,0,,0,1,1,100.0,0,1,0,0,0,0,0,0,1,0
67,João Cancelo,POR,DF,Manchester City,27,1994,35.9,89,54,31,36,22,35,83,42.2,48,347,119,34.3,106,138,103,45,4,1,41,75,164,56
68,Sergi Canós,ESP,DF,Brentford,24,1997,23.1,57,22,28,19,10,23,60,38.3,37,460,113,24.6,197,175,88,40,3,0,37,33,90,38
69,Todd Cantwell,ENG,"FW,MF",Norwich City,23,1998,4.9,15,11,8,6,1,4,14,28.6,10,106,25,23.6,39,46,21,2,0,0,2,4,19,3
70,Matty Cash,POL,DF,Aston Villa,23,1997,37.5,90,44,53,33,4,41,74,55.4,33,511,142,27.8,268,193,50,91,19,0,72,90,180,95
71,Timothy Castagne,BEL,DF,Leicester City,25,1995,23.6,66,29,33,26,7,23,44,52.3,21,349,108,30.9,150,152,47,53,8,0,45,38,104,65
72,Jonny Castro,ESP,DF,Wolves,27,1994,11.4,27,21,15,11,1,10,20,50.0,10,175,58,33.1,86,63,26,19,3,0,16,13,40,7
73,Craig Cathcart,NIR,DF,Watford,32,1989,26.6,33,15,26,7,0,16,34,47.1,18,165,51,30.9,117,45,3,55,32,0,23,38,71,129
74,Edinson Cavani,URU,FW,Manchester Utd,34,1987,8.5,4,2,0,3,1,3,6,50.0,3,105,39,37.1,14,36,55,9,0,0,9,9,13,7
75,Kayky Chagas,BRA,FW,Manchester City,18,2003,0.1,0,0,0,0,0,0,0,,0,3,0,0.0,1,1,1,0,0,0,0,0,0,0
76,Trevoh Chalobah,ENG,DF,Chelsea,22,1999,16.1,38,21,16,18,4,20,30,66.7,10,165,60,36.4,64,86,15,20,9,1,11,33,71,65
77,Calum Chambers,ENG,DF,Arsenal,26,1995,1.9,2,1,2,0,0,1,3,33.3,2,24,5,20.8,18,5,1,11,3,0,8,3,5,7
78,Calum Chambers,ENG,DF,Aston Villa,26,1995,9.2,20,11,11,7,2,5,7,71.4,2,94,31,33.0,50,40,4,21,10,0,11,11,31,59
79,Daniel Chesters,ENG,MF,West Ham,19,2002,0.0,0,0,0,0,0,0,0,,0,0,0,,0,0,0,0,0,0,0,0,0,0
80,Ben Chilwell,ENG,DF,Chelsea,24,1996,6.0,10,5,3,6,1,0,5,0.0,5,92,31,33.7,34,36,22,10,0,0,10,6,16,15
81,Chiquinho,POR,"DF,MF",Wolves,21,2000,2.3,9,6,3,6,0,3,4,75.0,1,58,14,24.1,14,29,15,3,0,0,3,6,15,3
82,Hamza Choudhury,ENG,"DF,MF",Leicester City,23,1997,3.2,8,2,3,5,0,2,5,40.0,3,42,6,14.3,15,24,3,5,0,0,5,16,24,12
83,Andreas Christensen,DEN,DF,Chelsea,25,1996,16.6,18,12,11,4,3,10,15,66.7,5,148,51,34.5,84,52,12,30,9,0,21,52,70,87
84,Carney Chukwuemeka,ENG,"MF,FW",Aston Villa,17,2004,3.3,3,2,1,2,0,2,6,33.3,4,86,25,29.1,23,48,15,3,0,0,3,4,7,1
85,Ciaran Clark,IRL,DF,Newcastle Utd,31,1989,11.3,17,13,9,6,2,9,15,60.0,6,76,27,35.5,53,19,4,14,10,0,4,15,32,50
86,Tom Cleverley,ENG,MF,Watford,31,1989,18.0,34,27,18,12,4,10,32,31.3,22,372,106,28.5,116,190,66,28,7,1,21,27,61,19
87,Nathaniel Clyne,ENG,DF,Crystal Palace,30,1991,15.0,22,11,9,12,1,7,15,46.7,8,126,43,34.1,64,43,19,10,2,0,8,33,55,31
88,Conor Coady,ENG,DF,Wolves,28,1993,37.3,31,18,20,10,1,12,26,46.2,14,197,68,34.5,124,68,5,64,50,3,14,44,75,150
89,Séamus Coleman,IRL,DF,Everton,32,1988,29.5,72,42,41,20,11,29,47,61.7,18,336,124,36.9,159,130,47,59,13,0,46,54,126,75
90,Nathan Collins,IRL,DF,Burnley,20,2001,18.6,30,23,24,4,2,9,23,39.1,14,161,54,33.5,103,46,12,48,26,1,22,37,67,102
91,Aaron Connolly,IRL,FW,Brighton,21,2000,1.7,0,0,0,0,0,0,1,0.0,1,27,5,18.5,4,11,12,2,0,0,2,0,0,0
92,Liam Cooper,SCO,DF,Leeds United,29,1991,20.2,35,18,21,13,1,15,27,55.6,12,201,74,36.8,123,75,3,32,18,0,14,40,75,117
93,Jack Cork,ENG,MF,Burnley,32,1989,18.6,17,8,4,10,3,5,24,20.8,19,343,94,27.4,107,176,60,26,5,0,21,34,51,27
94,Maxwel Cornet,CIV,"FW,MF",Burnley,24,1996,19.6,20,11,7,7,6,4,11,36.4,7,303,84,27.7,68,127,108,14,4,0,10,11,31,16
95,Hélder Costa,ANG,MF,Leeds United,27,1994,0.2,0,0,0,0,0,0,2,0.0,2,9,2,22.2,1,5,3,0,0,0,0,0,0,0
96,Vladimír Coufal,CZE,DF,West Ham,28,1992,24.5,44,22,25,11,8,16,37,43.2,21,301,79,26.2,141,98,62,50,9,0,41,34,78,74
97,Philippe Coutinho,BRA,"MF,FW",Aston Villa,29,1992,14.8,20,11,5,8,7,7,14,50.0,7,221,48,21.7,51,110,60,17,1,0,16,8,28,3
98,Aaron Cresswell,ENG,DF,West Ham,31,1989,30.3,30,19,20,8,2,14,27,51.9,13,213,67,31.5,111,73,29,48,17,0,31,43,73,76
99,Charlie Cresswell,ENG,DF,Leeds United,18,2002,1.6,7,3,4,3,0,3,3,100.0,0,29,5,17.2,14,15,0,2,1,0,1,4,11,10
100,Cucho,COL,"FW,MF",Watford,22,1999,12.7,16,5,8,6,2,4,32,12.5,28,260,57,21.9,70,109,81,12,1,0,11,11,27,10
101,Marc Cucurella,ESP,DF,Brighton,23,1998,34.3,88,62,36,38,14,48,77,62.3,29,534,201,37.6,215,218,101,72,15,2,57,72,160,66
102,Luke Cundle,ENG,MF,Wolves,19,2002,2.0,4,3,0,4,0,1,1,100.0,0,43,9,20.9,15,22,6,1,0,0,1,2,6,2
103,Patson Daka,ZAM,FW,Leicester City,22,1998,12.9,17,11,4,9,4,1,13,7.7,12,233,77,33.0,19,100,114,11,0,0,11,3,20,8
104,Stuart Dallas,NIR,"DF,MF",Leeds United,30,1991,32.4,90,46,59,25,6,48,115,41.7,67,531,177,33.3,262,212,57,64,16,1,48,78,168,66
105,Diogo Dalot,POR,DF,Manchester Utd,22,1999,20.0,58,33,34,15,9,27,44,61.4,17,232,72,31.0,110,84,38,37,12,3,25,44,102,61
106,Karl Darlow,ENG,GK,Newcastle Utd,30,1990,8.0,0,0,0,0,0,0,0,,0,0,0,,0,0,0,0,0,0,0,0,0,1
107,Josh Dasilva,ENG,"MF,FW",Brentford,22,1998,2.9,4,2,1,1,2,2,6,33.3,4,55,12,21.8,14,28,13,8,1,0,7,4,8,7
108,Ben Davies,WAL,DF,Tottenham,28,1993,28.2,40,18,18,15,7,12,34,35.3,22,269,86,32.0,133,92,44,39,18,2,21,45,85,93
109,Tom Davies,ENG,MF,Everton,23,1998,2.6,4,2,1,2,1,1,5,20.0,4,49,13,26.5,19,21,9,4,1,0,3,8,12,7
110,Keinan Davis,ENG,FW,Aston Villa,23,1998,0.1,0,0,0,0,0,0,0,,0,1,0,0.0,0,0,1,0,0,0,0,0,0,0
111,Craig Dawson,ENG,DF,West Ham,31,1990,30.6,33,21,20,13,0,12,27,44.4,15,199,67,33.7,126,64,9,66,55,0,11,30,63,145
112,Kevin De Bruyne,BEL,MF,Manchester City,30,1991,24.5,22,14,3,10,9,10,41,24.4,31,361,98,27.1,46,149,166,34,2,0,32,14,36,18
113,Troy Deeney,ENG,FW,Watford,33,1988,0.3,0,0,0,0,0,0,1,0.0,1,7,2,28.6,1,2,4,0,0,0,0,0,0,3
114,Liam Delap,ENG,FW,Manchester City,18,2003,0.1,0,0,0,0,0,0,1,0.0,1,2,0,0.0,0,1,1,0,0,0,0,0,0,0
115,Fabian Delph,ENG,MF,Everton,31,1989,7.4,19,13,8,9,2,6,22,27.3,16,127,39,30.7,35,77,15,13,5,0,8,19,38,9
116,Leander Dendoncker,BEL,MF,Wolves,26,1995,21.7,45,24,24,20,1,18,37,48.6,19,442,120,27.1,185,201,56,47,11,0,36,24,69,33
117,Emmanuel Dennis,NGA,"FW,MF",Watford,23,1997,28.7,46,28,24,14,8,13,42,31.0,29,563,146,25.9,124,249,190,35,2,0,33,25,71,14
118,Kiernan Dewsbury Hall,ENG,MF,Leicester City,22,1998,23.4,40,25,24,12,4,13,35,37.1,22,468,113,24.1,155,183,130,46,8,0,38,27,67,28
119,Ibrahima Diallo,FRA,MF,Southampton,22,1999,11.4,27,20,12,11,4,8,24,33.3,16,229,68,29.7,76,114,39,10,0,0,10,17,44,9
120,Raphael Dias Belloli,BRA,"FW,MF",Leeds United,24,1996,32.4,54,25,24,19,11,18,69,26.1,51,574,136,23.7,142,239,193,59,2,0,57,43,97,23
121,Rúben Dias,POR,DF,Manchester City,24,1997,26.7,34,27,12,18,4,7,16,43.8,9,153,68,44.4,57,78,18,28,13,0,15,38,72,78
122,Luis Díaz,COL,FW,Liverpool,24,1997,10.6,12,10,4,4,4,3,10,30.0,7,163,59,36.2,26,64,73,9,1,0,8,4,16,2
123,Eric Dier,ENG,DF,Tottenham,27,1994,34.1,25,13,11,11,3,4,13,30.8,9,181,70,38.7,93,79,9,56,38,1,18,47,72,168
124,Lucas Digne,FRA,DF,Aston Villa,28,1993,14.1,19,10,12,4,3,7,18,38.9,11,157,34,21.7,74,52,31,29,8,0,21,32,51,42
125,Lucas Digne,FRA,DF,Everton,28,1993,13.0,35,17,26,5,4,22,30,73.3,8,161,43,26.7,80,50,31,28,5,0,23,31,66,30
126,Virgil van Dijk,NED,DF,Liverpool,30,1991,34.0,21,12,13,7,1,11,15,73.3,4,124,44,35.5,72,45,7,31,16,1,15,47,68,135
127,Issa Diop,FRA,DF,West Ham,24,1997,10.7,9,3,4,5,0,2,10,20.0,8,72,28,38.9,41,30,1,23,15,0,8,17,26,44
128,Moussa Djenepo,MLI,MF,Southampton,23,1998,5.1,13,8,6,6,1,5,12,41.7,7,104,25,24.0,46,39,19,9,1,0,8,9,22,3
129,Lewis Dobbin,ENG,"FW,MF",Everton,18,2003,0.4,2,2,0,1,1,0,2,0.0,2,19,5,26.3,4,7,8,0,0,0,0,1,3,0
130,Matt Doherty,IRL,DF,Tottenham,29,1992,9.7,18,12,9,8,1,7,12,58.3,5,120,42,35.0,50,54,16,24,2,0,22,17,35,15
131,Gabriel Dos Santos,BRA,DF,Arsenal,23,1997,34.0,57,37,39,14,4,23,35,65.7,12,222,86,38.7,131,77,14,49,28,0,21,39,96,117
132,Abdoulaye Doucouré,MLI,MF,Everton,28,1993,28.2,76,45,37,36,3,26,70,37.1,44,656,179,27.3,248,308,100,42,8,0,34,41,117,33
133,Kieran Dowell,ENG,"FW,MF",Norwich City,23,1997,10.1,17,7,6,8,3,8,32,25.0,24,270,49,18.1,67,121,82,10,1,0,9,9,26,2
134,Cody Drameh,ENG,DF,Leeds United,19,2001,1.4,6,3,4,2,0,2,4,50.0,2,29,8,27.6,16,10,3,2,0,0,2,3,9,2
135,Martin Dúbravka,SVK,GK,Newcastle Utd,32,1989,26.0,0,0,0,0,0,0,2,0.0,2,5,1,20.0,5,0,0,0,0,0,0,0,0,0
136,Shane Duffy,IRL,DF,Brighton,29,1992,16.0,16,9,12,1,3,5,13,38.5,8,85,19,22.4,50,31,4,35,19,1,16,18,34,91
137,Paul Dummett,WAL,DF,Newcastle Utd,29,1991,2.2,9,4,6,2,1,5,8,62.5,3,31,12,38.7,15,13,3,3,0,0,3,4,13,9
138,Lewis Dunk,ENG,DF,Brighton,29,1991,28.6,20,11,9,10,1,6,13,46.2,7,125,48,38.4,74,41,10,42,27,0,15,46,66,119
139,Ederson,BRA,GK,Manchester City,27,1993,37.0,0,0,0,0,0,0,2,0.0,2,5,0,0.0,5,0,0,0,0,0,0,0,0,0
140,Odsonne Édouard,FRA,FW,Crystal Palace,23,1998,17.4,17,13,2,7,8,2,19,10.5,17,340,98,28.8,45,142,153,24,5,0,19,11,28,16
141,CJ Egan-Riley,ENG,DF,Manchester City,18,2003,0.0,1,1,1,0,0,1,1,100.0,0,0,0,,0,0,0,0,0,0,0,0,1,0
142,Anthony Elanga,SWE,FW,Manchester Utd,19,2002,13.5,25,17,12,10,3,8,26,30.8,18,289,80,27.7,93,124,72,24,2,0,22,19,44,6
143,Harvey Elliott,ENG,MF,Liverpool,18,2003,3.8,3,1,1,0,2,1,7,14.3,6,94,21,22.3,21,50,23,9,1,0,8,3,6,4
144,Mohamed Elneny,EGY,MF,Arsenal,29,1992,9.0,17,9,10,6,1,3,7,42.9,4,108,38,35.2,49,50,9,9,1,0,8,18,35,12
145,Mohamed Elyounoussi,NOR,"MF,FW",Southampton,26,1994,22.7,46,33,14,24,8,10,31,32.3,21,499,156,31.3,144,235,120,37,4,0,33,19,65,24
146,Emerson,BRA,DF,Tottenham,22,1999,25.4,86,39,56,24,6,28,60,46.7,32,500,126,25.2,245,177,78,56,4,0,52,35,121,79
147,Christian Eriksen,DEN,MF,Brentford,29,1992,10.4,18,10,7,8,3,9,13,69.2,4,150,32,21.3,38,86,26,13,1,0,12,10,28,11
148,Oghenekaro Etebo,NGA,MF,Watford,25,1995,4.5,12,10,5,7,0,4,7,57.1,3,65,22,33.8,29,32,4,5,1,0,4,8,20,6
149,Jonny Evans,NIR,DF,Leicester City,33,1988,15.0,27,18,18,7,2,16,28,57.1,12,123,49,39.8,77,41,5,22,13,0,9,31,58,61
150,Eberechi Eze,ENG,"MF,FW",Crystal Palace,23,1998,6.7,10,5,4,3,3,6,12,50.0,6,86,24,27.9,18,48,20,7,1,0,6,8,18,1
151,Łukasz Fabiański,POL,GK,West Ham,36,1985,37.0,0,0,0,0,0,0,0,,0,1,1,100.0,1,0,0,0,0,0,0,0,0,0
152,Fabinho,BRA,MF,Liverpool,27,1993,25.7,57,37,17,33,7,19,62,30.6,43,413,131,31.7,126,225,62,51,10,0,41,56,113,30
153,Kiko Femenía,ESP,DF,Watford,30,1991,23.8,43,26,29,11,3,24,41,58.5,17,227,75,33.0,112,85,30,39,10,0,29,63,106,61
154,Evan Ferguson,IRL,MF,Brighton,16,2004,0.3,0,0,0,0,0,0,0,,0,1,0,0.0,0,0,1,0,0,0,0,0,0,0
155,Nathan Ferguson,ENG,DF,Crystal Palace,20,2000,0.1,0,0,0,0,0,0,0,,0,1,0,0.0,1,0,0,0,0,0,0,0,0,0
156,Bruno Fernandes,POR,MF,Manchester Utd,26,1994,34.6,59,45,30,22,7,24,74,32.4,50,610,172,28.2,120,290,200,29,0,0,29,38,97,40
157,Álvaro Fernández,ESP,GK,Brentford,23,1998,12.0,0,0,0,0,0,0,0,,0,0,0,,0,0,0,0,0,0,0,0,0,0
158,Federico Fernández,ARG,DF,Newcastle Utd,32,1989,5.8,1,1,0,1,0,0,6,0.0,6,33,4,12.1,21,9,3,11,9,0,2,13,14,23
159,Fernandinho,BRA,"MF,DF",Manchester City,36,1985,10.7,23,16,8,13,2,6,19,31.6,13,130,45,34.6,42,74,14,6,3,0,3,14,37,23
160,Roberto Firmino,BRA,FW,Liverpool,29,1991,11.0,34,21,5,17,12,4,15,26.7,11,249,85,34.1,32,114,103,20,0,0,20,4,38,3
161,Junior Firpo,ESP,DF,Leeds United,24,1996,19.0,73,38,41,27,5,33,68,48.5,35,356,103,28.9,184,130,42,37,8,1,29,33,106,47
162,Ashley Fletcher,ENG,FW,Watford,25,1995,0.3,2,2,2,0,0,1,1,100.0,0,9,1,11.1,5,3,1,1,1,0,0,0,2,0
163,Phil Foden,ENG,FW,Manchester City,21,2000,23.6,19,15,8,5,6,7,10,70.0,3,410,135,32.9,44,132,234,12,2,0,10,17,36,1
164,Wesley Fofana,FRA,DF,Leicester City,20,2000,7.0,10,5,9,1,0,7,9,77.8,2,56,22,39.3,38,18,0,6,2,0,4,16,26,28
165,Pablo Fornals,ESP,"FW,MF",West Ham,25,1996,31.1,51,34,22,18,11,26,87,29.9,61,664,179,27.0,190,299,175,52,3,0,49,47,98,16
166,Adam Forshaw,ENG,MF,Leeds United,29,1991,17.0,51,28,20,29,2,21,48,43.8,27,408,124,30.4,127,215,66,19,1,0,18,30,81,19
167,Marcus Forss,FIN,"FW,MF",Brentford,22,1999,2.3,4,2,0,3,1,2,4,50.0,2,70,21,30.0,11,29,30,3,0,0,3,2,6,0
168,Fraser Forster,ENG,GK,Southampton,33,1988,19.0,1,0,1,0,0,0,1,0.0,1,3,1,33.3,3,0,0,0,0,0,0,0,1,4
169,Ben Foster,ENG,GK,Watford,38,1983,26.0,0,0,0,0,0,0,3,0.0,3,7,1,14.3,7,0,0,0,0,0,0,0,0,6
170,Tariqe Fosu,GHA,DF,Brentford,25,1995,0.2,0,0,0,0,0,0,0,,0,5,0,0.0,0,2,3,1,0,0,1,0,0,0
171,Ryan Fraser,SCO,"FW,MF",Newcastle Utd,27,1994,16.3,13,4,8,5,0,4,16,25.0,12,166,42,25.3,33,71,62,14,1,0,13,16,29,9
172,Fred,BRA,MF,Manchester Utd,28,1993,22.5,66,38,29,28,9,19,71,26.8,52,554,141,25.5,193,298,63,47,14,0,33,49,115,30
173,Ryan Fredericks,ENG,DF,West Ham,28,1992,3.4,4,2,4,0,0,2,4,50.0,2,24,5,20.8,13,7,4,4,1,0,3,6,10,9
174,Leo Fuhr Hjelde,NOR,DF,Leeds United,17,2003,1.7,4,2,4,0,0,3,3,100.0,0,30,11,36.7,13,12,5,3,3,0,0,4,8,8
175,Conor Gallagher,ENG,MF,Crystal Palace,21,2000,31.6,69,44,33,20,16,14,61,23.0,47,781,221,28.3,208,361,212,56,10,0,46,43,112,27
176,Alejandro Garnacho,ESP,FW,Manchester Utd,17,2004,0.1,0,0,0,0,0,0,1,0.0,1,9,0,0.0,4,4,1,0,0,0,0,0,0,0
177,Dwight Gayle,ENG,FW,Newcastle Utd,30,1990,0.4,1,0,0,1,0,0,0,,0,18,5,27.8,1,12,5,0,0,0,0,1,2,0
178,Jean-Philippe Gbamin,CIV,MF,Everton,25,1995,0.7,2,1,1,1,0,0,1,0.0,1,14,7,50.0,8,3,3,0,0,0,0,0,2,1
179,David de Gea,ESP,GK,Manchester Utd,30,1990,38.0,0,0,0,0,0,0,0,,0,1,0,0.0,1,0,0,0,0,0,0,0,0,0
180,Joe Gelhardt,ENG,"FW,MF",Leeds United,19,2002,8.3,12,6,4,2,6,3,10,30.0,7,204,68,33.3,19,93,92,8,0,0,8,4,16,3
181,Anwar El Ghazi,NED,"FW,MF",Aston Villa,26,1995,4.3,3,3,1,2,0,2,6,33.3,4,48,18,37.5,7,24,17,5,0,0,5,2,5,2
182,Anwar El Ghazi,NED,FW,Everton,26,1995,0.1,1,1,1,0,0,1,1,100.0,0,10,3,30.0,2,3,5,2,0,0,2,1,2,0
183,Saman Ghoddos,IRN,"DF,MF",Brentford,27,1993,6.0,17,8,8,7,2,8,12,66.7,4,117,26,22.2,37,48,32,13,0,0,13,7,24,13
184,Dimitris Giannoulis,GRE,DF,Norwich City,25,1995,13.0,40,23,22,16,2,22,35,62.9,13,204,54,26.5,105,69,30,38,6,0,32,36,76,31
185,Morgan Gibbs-White,ENG,"FW,MF",Wolves,21,2000,0.1,0,0,0,0,0,0,0,,0,3,0,0.0,1,1,1,1,0,0,1,0,0,0
186,Ben Gibson,ENG,DF,Norwich City,28,1993,27.7,21,17,16,5,0,5,11,45.5,6,152,51,33.6,97,49,6,56,33,0,23,48,69,159
187,Billy Gilmour,SCO,MF,Norwich City,20,2001,20.6,48,22,19,24,5,15,41,36.6,26,495,101,20.4,203,235,57,23,5,0,18,33,81,32
188,Ben Godfrey,ENG,DF,Everton,23,1998,22.5,53,26,29,19,5,16,30,53.3,14,266,89,33.5,134,109,23,48,20,0,28,48,101,98
189,André Gomes,POR,MF,Everton,28,1993,6.9,15,9,6,5,4,7,22,31.8,15,198,51,25.8,70,92,36,13,2,0,11,11,26,3
190,Toti Gomes,POR,DF,Wolves,22,1999,4.0,7,3,6,1,0,3,8,37.5,5,34,15,44.1,19,10,5,10,2,0,8,10,17,20
191,Joe Gomez,ENG,DF,Liverpool,24,1997,3.7,7,4,5,0,2,2,6,33.3,4,42,16,38.1,18,16,8,3,1,0,2,12,19,8
192,Charlie Goode,ENG,DF,Brentford,25,1995,5.0,8,5,6,2,0,4,4,100.0,0,36,15,41.7,20,13,3,5,2,0,3,5,13,12
193,Anthony Gordon,ENG,"MF,FW",Everton,20,2001,25.4,62,36,29,23,10,22,63,34.9,41,596,154,25.8,153,275,168,58,5,0,53,36,98,8
194,Kaide Gordon,ENG,FW,Liverpool,16,2004,0.1,1,0,0,0,1,1,1,100.0,0,6,3,50.0,0,1,5,0,0,0,0,0,1,0
195,Dan Gosling,ENG,MF,Watford,31,1990,1.8,2,1,2,0,0,1,6,16.7,5,28,7,25.0,9,13,6,1,0,0,1,1,3,3
196,Demarai Gray,ENG,"MF,FW",Everton,25,1996,26.0,33,19,13,12,8,15,32,46.9,17,339,109,32.2,83,133,123,38,2,0,36,16,49,15
197,Jack Grealish,ENG,FW,Manchester City,25,1995,21.3,20,15,4,12,4,3,12,25.0,9,269,105,39.0,39,90,140,20,2,0,18,16,36,7
198,Mason Greenwood,ENG,"FW,MF",Manchester Utd,19,2001,14.1,16,8,8,2,6,5,12,41.7,7,154,40,26.0,35,59,60,5,0,0,5,4,20,5
199,Sam Greenwood,ENG,"MF,FW",Leeds United,19,2002,2.6,8,2,0,7,1,3,7,42.9,4,73,16,21.9,7,42,24,2,1,0,1,2,10,3
200,Pascal Groß,GER,"MF,DF",Brighton,30,1991,22.6,31,21,18,10,3,12,34,35.3,22,401,118,29.4,130,149,122,39,7,0,32,16,47,24
201,Vicente Guaita,ESP,GK,Crystal Palace,34,1987,29.5,0,0,0,0,0,0,0,,0,1,0,0.0,1,0,0,0,0,0,0,0,0,0
202,Marc Guéhi,ENG,DF,Crystal Palace,21,2000,35.8,33,22,23,9,1,11,17,64.7,6,223,91,40.8,142,70,11,46,29,0,17,58,91,143
203,Bruno Guimarães,BRA,MF,Newcastle Utd,23,1997,11.5,51,39,26,21,4,14,32,43.8,18,299,89,29.8,108,144,47,27,7,0,20,19,70,9
204,İlkay Gündoğan,GER,MF,Manchester City,30,1990,20.6,21,11,9,11,1,9,25,36.0,16,196,56,28.6,50,93,53,19,3,1,16,27,48,10
205,Angus Gunn,ENG,GK,Norwich City,25,1996,9.0,0,0,0,0,0,0,0,,0,2,0,0.0,2,0,0,0,0,0,0,0,0,1
206,Grant Hanley,SCO,DF,Norwich City,29,1991,32.2,55,38,38,14,3,14,29,48.3,15,269,102,37.9,192,67,10,77,54,1,23,65,120,196
207,Jack Harrison,ENG,"FW,MF",Leeds United,24,1996,29.3,56,32,20,23,13,26,59,44.1,33,600,168,28.0,170,254,176,53,3,0,50,41,97,31
208,Kortney Hause,ENG,DF,Aston Villa,26,1995,4.4,4,4,3,0,1,2,2,100.0,0,47,21,44.7,30,16,1,10,5,0,5,9,13,19
209,Kai Havertz,GER,"FW,MF",Chelsea,22,1999,20.1,21,13,4,12,5,5,18,27.8,13,352,95,27.0,36,128,188,37,1,0,36,6,27,30
210,Isaac Hayden,ENG,"MF,DF",Newcastle Utd,26,1995,11.1,34,18,17,12,5,8,23,34.8,15,194,53,27.3,77,96,21,22,9,0,13,20,54,30
211,Hwang Hee-chan,KOR,"FW,MF",Wolves,25,1996,20.2,28,14,9,17,2,13,36,36.1,23,272,64,23.5,53,133,86,14,0,0,14,25,53,8
212,Jordan Henderson,ENG,MF,Liverpool,31,1990,28.9,37,24,7,26,4,16,47,34.0,31,467,146,31.3,99,257,111,31,3,0,28,43,80,17
213,Jeff Hendrick,IRL,MF,Newcastle Utd,29,1992,0.8,1,1,0,1,0,1,1,100.0,0,16,2,12.5,2,11,3,0,0,0,0,0,1,1
214,Wayne Hennessey,WAL,GK,Burnley,34,1987,2.0,0,0,0,0,0,0,0,,0,1,0,0.0,1,0,0,0,0,0,0,0,0,0
215,Rico Henry,ENG,DF,Brentford,24,1997,30.8,42,27,27,8,7,11,36,30.6,25,396,106,26.8,183,133,80,74,12,0,62,59,101,62
216,Son Heung-min,KOR,"FW,MF",Tottenham,29,1992,33.4,19,12,7,9,3,5,26,19.2,21,383,96,25.1,65,190,128,32,8,0,24,29,48,11
217,Ki-Jana Hoever,NED,DF,Wolves,19,2002,3.4,16,10,12,4,0,5,13,38.5,8,81,25,30.9,40,30,11,6,0,0,6,5,21,8
218,Rob Holding,ENG,DF,Arsenal,25,1995,9.4,12,7,10,1,1,5,8,62.5,3,62,19,30.6,35,23,4,25,18,0,7,15,27,50
219,Mason Holgate,ENG,DF,Everton,24,1996,23.7,44,26,31,12,1,14,30,46.7,16,231,78,33.8,142,74,15,30,19,2,11,42,86,127
220,Callum Hudson-Odoi,ENG,"FW,MF",Chelsea,20,2000,10.7,13,6,4,7,2,3,15,20.0,12,158,38,24.1,24,77,57,13,0,0,13,5,18,5
221,Will Hughes,ENG,MF,Crystal Palace,26,1995,11.7,29,15,9,17,3,7,19,36.8,12,212,56,26.4,71,121,20,25,7,0,18,22,51,14
222,Pierre Højbjerg,DEN,MF,Tottenham,25,1995,35.5,84,49,28,45,11,29,80,36.3,51,669,176,26.3,255,319,95,73,13,0,60,70,154,61
223,Adam Idah,IRL,"FW,MF",Norwich City,20,2001,6.9,11,6,4,5,2,2,5,40.0,3,93,23,24.7,15,40,38,4,3,0,1,4,15,8
224,Kelechi Iheanacho,NGA,FW,Leicester City,24,1996,14.0,15,9,2,9,4,4,12,33.3,8,244,65,26.6,17,111,116,16,1,0,15,4,19,10
225,Danny Ings,ENG,FW,Aston Villa,29,1992,21.1,26,11,6,14,6,11,28,39.3,17,385,89,23.1,52,165,168,30,4,0,26,15,41,19
226,Tim Iroegbunam,ENG,MF,Aston Villa,18,2003,1.0,5,2,3,2,0,1,2,50.0,1,24,8,33.3,6,16,2,1,0,0,1,2,7,1
227,Alex Iwobi,NGA,"MF,DF",Everton,25,1996,22.6,46,28,24,15,7,20,47,42.6,27,519,153,29.5,182,211,126,45,4,0,41,40,86,23
228,Daniel James,WAL,FW,Manchester Utd,23,1997,1.4,4,4,0,4,0,1,1,100.0,0,31,8,25.8,5,13,13,2,0,0,2,0,4,1
229,Daniel James,WAL,"FW,MF",Leeds United,23,1997,26.3,35,17,12,13,10,11,27,40.7,16,580,149,25.7,87,221,272,24,2,0,22,19,54,12
230,Reece James,ENG,DF,Chelsea,21,1999,20.7,39,23,22,14,3,8,25,32.0,17,265,93,35.1,98,107,60,29,3,1,26,21,60,21
231,Vitaly Janelt,GER,MF,Brentford,23,1998,25.5,62,35,23,28,11,17,44,38.6,27,487,145,29.8,128,246,113,43,8,0,35,44,106,34
232,Pontus Jansson,SWE,DF,Brentford,30,1991,36.9,36,25,27,8,1,17,36,47.2,19,204,75,36.8,120,71,13,56,27,0,29,69,105,208
233,Mathias Jensen,DEN,MF,Brentford,25,1996,17.8,34,28,12,17,5,19,61,31.1,42,456,133,29.2,166,214,76,33,4,0,29,33,67,14
234,Gabriel Jesus,BRA,FW,Manchester City,24,1997,20.9,24,12,5,6,13,6,25,24.0,19,295,72,24.4,33,129,133,25,1,0,24,18,42,7
235,Raúl Jiménez,MEX,FW,Wolves,30,1991,29.2,33,23,4,18,11,4,21,19.0,17,445,108,24.3,41,234,170,36,8,1,28,19,52,27
236,Joelinton,BRA,"MF,FW",Newcastle Utd,24,1996,28.4,72,44,33,28,11,23,56,41.1,33,610,163,26.7,190,277,143,67,12,0,55,48,120,47
237,Ben Johnson,ENG,DF,West Ham,21,2000,15.5,30,16,14,12,4,17,30,56.7,13,172,61,35.5,87,53,32,49,10,1,39,25,55,49
238,Curtis Jones,ENG,MF,Liverpool,20,2001,9.5,12,9,3,8,1,2,9,22.2,7,212,61,28.8,37,116,59,5,0,0,5,10,22,2
239,Phil Jones,ENG,DF,Manchester Utd,29,1992,1.8,6,4,4,1,1,3,4,75.0,1,23,4,17.4,11,11,1,3,3,0,0,5,11,9
240,Jorginho,ITA,MF,Chelsea,29,1991,25.3,68,46,30,32,6,23,76,30.3,53,488,175,35.9,176,237,75,35,6,0,29,60,128,21
241,Diogo Jota,POR,FW,Liverpool,24,1996,26.3,36,21,14,15,7,10,47,21.3,37,589,164,27.8,98,237,254,19,3,0,16,17,53,6
242,James Justin,ENG,DF,Leicester City,23,1998,11.1,31,21,14,12,5,9,18,50.0,9,181,52,28.7,86,72,23,28,5,0,23,27,58,33
243,Mathias Jørgensen,DEN,DF,Brentford,31,1990,5.8,11,2,4,4,3,6,9,66.7,3,54,13,24.1,28,19,7,8,1,0,7,10,21,14
244,Ozan Kabak,TUR,DF,Norwich City,21,2000,10.2,13,11,6,6,1,4,9,44.4,5,94,38,40.4,65,27,2,19,12,0,7,22,35,29
245,Christian Kabasele,BEL,DF,Watford,30,1991,13.3,10,6,7,3,0,3,5,60.0,2,83,35,42.2,57,24,2,33,17,0,16,26,36,58
246,Samuel Kalu,NGA,FW,Watford,23,1997,2.5,2,2,0,2,0,1,2,50.0,1,23,6,26.1,7,6,10,3,0,0,3,5,7,3
247,Hassane Kamara,CIV,DF,Watford,27,1994,18.0,61,29,38,18,5,24,40,60.0,16,300,75,25.0,177,101,22,33,5,0,28,94,155,57
248,Harry Kane,ENG,FW,Tottenham,28,1993,35.9,19,10,3,11,5,8,25,32.0,17,378,110,29.1,27,150,201,22,9,1,13,7,26,38
249,N'Golo Kanté,FRA,MF,Chelsea,30,1991,19.7,57,34,22,22,13,19,38,50.0,19,385,134,34.8,123,180,82,37,2,0,35,44,101,14
250,Edo Kayembe,COD,MF,Watford,22,1998,8.9,21,15,10,9,2,5,10,50.0,5,127,47,37.0,63,59,5,13,1,0,12,14,35,20
251,Moise Kean,ITA,FW,Everton,21,2000,0.0,0,0,0,0,0,0,0,,0,0,0,,0,0,0,0,0,0,0,0,0,0
252,Michael Keane,ENG,DF,Everton,28,1993,31.0,49,35,35,12,2,25,43,58.1,18,228,93,40.8,131,81,16,51,32,0,19,62,111,149
253,Naby Keïta,GUI,MF,Liverpool,26,1995,13.0,47,28,19,19,9,18,35,51.4,17,321,107,33.3,74,161,86,24,2,0,22,20,67,4
254,Caoimhín Kelleher,IRL,GK,Liverpool,22,1998,2.0,0,0,0,0,0,0,0,,0,0,0,,0,0,0,0,0,0,0,0,0,0
255,Kenedy,BRA,DF,Chelsea,25,1996,0.6,3,2,0,1,2,0,2,0.0,2,9,2,22.2,1,5,3,2,0,0,2,0,3,0
256,Jonjoe Kenny,ENG,DF,Everton,24,1997,11.3,19,12,9,9,1,14,28,50.0,14,141,51,36.2,64,64,13,17,2,0,15,32,51,21
257,Max Kilman,ENG,DF,Wolves,24,1997,29.9,53,33,40,13,0,20,33,60.6,13,240,92,38.3,159,70,11,52,21,0,31,64,117,118
258,Joshua King,NOR,FW,Watford,29,1992,25.0,31,21,6,17,8,5,16,31.3,11,486,134,27.6,69,221,196,21,5,0,16,12,43,27
259,Kristoffer Klaesson,NOR,GK,Leeds United,20,2000,0.4,0,0,0,0,0,0,0,,0,0,0,,0,0,0,0,0,0,0,0,0,0
260,Mateusz Klich,POL,MF,Leeds United,31,1990,23.0,49,26,18,24,7,19,66,28.8,47,595,150,25.2,178,312,105,24,6,0,18,31,80,24
261,Robin Koch,GER,"MF,DF",Leeds United,25,1996,17.5,31,20,15,11,5,12,36,33.3,24,299,100,33.4,135,131,33,33,11,1,22,34,65,46
262,Sead Kolašinac,BIH,DF,Arsenal,28,1993,1.0,1,1,1,0,0,0,0,,0,12,3,25.0,7,3,2,2,0,0,2,4,5,8
263,Ibrahima Konaté,FRA,DF,Liverpool,22,1999,11.0,14,8,6,7,1,3,7,42.9,4,86,23,26.7,44,36,6,15,10,1,5,28,42,47
264,Ezri Konsa,ENG,DF,Aston Villa,23,1997,27.5,26,14,15,10,1,7,13,53.8,6,179,64,35.8,106,60,13,43,22,0,21,45,71,81
265,Cheikhou Kouyaté,SEN,MF,Crystal Palace,31,1989,21.9,60,34,32,26,2,15,34,44.1,19,393,115,29.3,193,177,23,59,17,0,42,45,105,54
266,Mateo Kovačić,CRO,MF,Chelsea,27,1994,17.3,52,40,15,27,10,17,33,51.5,16,379,115,30.3,97,214,68,18,4,0,14,20,72,13
267,Emil Krafth,SWE,DF,Newcastle Utd,26,1994,18.2,39,20,29,9,1,21,39,53.8,18,232,64,27.6,112,95,25,38,10,0,28,48,87,53
268,Alex Král,CZE,MF,West Ham,23,1998,0.0,0,0,0,0,0,0,0,,0,2,2,100.0,0,1,1,0,0,0,0,0,0,0
269,Tim Krul,NED,GK,Norwich City,33,1988,29.0,0,0,0,0,0,0,3,0.0,3,9,2,22.2,9,0,0,1,0,0,1,0,0,0
270,Juraj Kucka,SVK,MF,Watford,34,1987,21.3,74,47,41,27,6,28,67,41.8,39,423,135,31.9,157,201,65,39,9,1,30,46,120,50
271,Dejan Kulusevski,SWE,"MF,FW",Tottenham,21,2000,14.0,20,16,9,10,1,6,19,31.6,13,310,79,25.5,112,126,72,11,0,0,11,26,46,1
272,Alexandre Lacazette,FRA,"FW,MF",Arsenal,30,1991,19.8,26,19,7,13,6,7,15,46.7,8,358,108,30.2,47,126,185,13,2,0,11,13,39,6
273,Adam Lallana,ENG,MF,Brighton,33,1988,17.3,38,22,19,15,4,11,36,30.6,25,303,104,34.3,113,133,57,26,8,0,18,27,65,15
274,Tariq Lamptey,ENG,"DF,FW",Brighton,20,2000,17.3,38,23,15,18,5,14,26,53.8,12,245,74,30.2,78,96,71,22,4,0,18,37,75,19
275,Manuel Lanzini,ARG,"MF,FW",West Ham,28,1993,19.8,25,18,11,8,6,12,41,29.3,29,373,95,25.5,107,192,74,22,1,0,21,28,53,7
276,Aymeric Laporte,ESP,DF,Manchester City,27,1994,31.4,31,17,20,10,1,15,25,60.0,10,139,63,45.3,81,50,8,24,11,0,13,33,64,78
277,Jamaal Lascelles,ENG,DF,Newcastle Utd,27,1993,22.9,21,11,16,3,2,7,18,38.9,11,154,51,33.1,94,53,7,50,32,1,18,35,56,134
278,Pierre Lees-Melou,FRA,MF,Norwich City,28,1993,25.2,65,40,29,26,10,24,82,29.3,58,650,162,24.9,249,307,94,41,12,2,29,42,107,19
279,Aaron Lennon,ENG,MF,Burnley,34,1987,17.2,38,18,13,16,9,9,39,23.1,30,348,83,23.9,97,142,109,32,4,0,28,15,53,13
280,Bernd Leno,GER,GK,Arsenal,29,1992,4.0,0,0,0,0,0,0,0,,0,0,0,,0,0,0,0,0,0,0,0,0,0
281,Jamal Lewis,NIR,DF,Newcastle Utd,23,1998,2.9,11,6,7,2,2,3,4,75.0,1,42,14,33.3,25,8,9,5,2,0,3,6,17,6
282,Victor Lindelöf,SWE,DF,Manchester Utd,27,1994,26.2,19,10,9,9,1,9,16,56.3,7,155,58,37.4,75,73,7,42,20,0,22,51,70,120
283,Jesse Lingard,ENG,"FW,MF",Manchester Utd,28,1992,4.1,11,6,3,6,2,2,3,66.7,1,110,28,25.5,20,45,45,3,0,0,3,4,15,1
284,Valentino Livramento,ENG,DF,Southampton,18,2002,24.5,54,30,32,17,5,25,45,55.6,20,332,110,33.1,164,125,43,45,10,0,35,73,127,49
285,Diego Llorente,ESP,DF,Leeds United,27,1993,26.0,56,35,38,16,2,30,53,56.6,23,361,140,38.8,208,140,13,61,19,0,42,61,117,104
286,Hugo Lloris,FRA,GK,Tottenham,34,1986,38.0,0,0,0,0,0,0,1,0.0,1,4,1,25.0,3,1,0,0,0,0,0,0,0,0
287,Giovani Lo Celso,ARG,"MF,FW",Tottenham,25,1996,2.6,8,3,4,3,1,3,12,25.0,9,69,14,20.3,26,29,14,7,1,0,6,3,11,0
288,Jürgen Locadia,NED,FW,Brighton,27,1993,0.3,1,1,0,1,0,0,0,,0,4,3,75.0,0,2,2,0,0,0,0,0,1,0
289,Ruben Loftus-Cheek,ENG,"MF,DF",Chelsea,25,1996,15.5,31,20,17,10,4,5,16,31.3,11,251,84,33.5,81,124,46,21,6,0,15,15,46,22
290,Kevin Long,IRL,DF,Burnley,30,1990,4.6,6,5,3,3,0,0,2,0.0,2,42,13,31.0,22,16,4,8,3,0,5,7,13,15
291,Shane Long,IRL,FW,Southampton,34,1987,3.4,8,3,2,4,2,1,1,100.0,0,83,24,28.9,10,32,41,3,0,0,3,1,9,1
292,Sean Longstaff,ENG,MF,Newcastle Utd,23,1997,16.3,51,33,20,24,7,19,62,30.6,43,427,108,25.3,158,209,60,27,6,0,21,20,71,22
293,Ademola Lookman,NGA,"FW,MF",Leicester City,23,1997,16.1,41,25,14,20,7,9,26,34.6,17,345,98,28.4,81,163,101,26,1,0,25,20,61,2
294,Jonas Lössl,DEN,GK,Brentford,32,1989,2.0,0,0,0,0,0,0,0,,0,0,0,,0,0,0,0,0,0,0,0,0,0
295,Imran Louza,MAR,MF,Watford,22,1999,15.7,51,32,25,21,5,20,44,45.5,24,345,105,30.4,143,159,43,23,6,0,17,48,99,22
296,Matthew Lowton,ENG,DF,Burnley,32,1989,19.7,45,26,21,17,7,21,46,45.7,25,188,61,32.4,74,70,44,45,13,0,32,34,79,68
297,Douglas Luiz,BRA,MF,Aston Villa,23,1998,30.2,64,43,35,24,5,24,73,32.9,49,524,156,29.8,229,243,52,44,8,0,36,61,125,29
298,Romelu Lukaku,BEL,FW,Chelsea,28,1993,17.7,5,3,0,2,3,2,5,40.0,3,190,55,28.9,6,63,121,10,3,0,7,1,6,21
299,Lyanco,BRA,DF,Southampton,24,1997,10.1,17,14,11,6,0,5,14,35.7,9,99,43,43.4,54,44,1,28,17,0,11,29,46,66
300,Alexis Mac Allister,ARG,"MF,FW",Brighton,22,1998,23.6,73,51,27,31,15,22,59,37.3,37,565,199,35.2,162,258,145,45,7,0,38,24,97,20
301,James Maddison,ENG,"MF,FW",Leicester City,24,1996,27.3,45,24,10,25,10,8,31,25.8,23,498,114,22.9,116,251,131,27,3,0,24,20,65,10
302,Harry Maguire,ENG,DF,Manchester Utd,28,1993,27.9,41,26,25,11,5,14,27,51.9,13,173,65,37.6,118,49,6,46,32,0,14,53,94,130
303,Riyad Mahrez,ALG,FW,Manchester City,30,1991,16.6,10,6,4,2,4,3,15,20.0,12,192,58,30.2,33,80,79,16,1,0,15,13,23,1
304,Ainsley Maitland-Niles,ENG,MF,Arsenal,23,1997,3.0,7,4,4,2,1,1,4,25.0,3,54,17,31.5,19,25,10,5,1,0,4,3,10,4
305,Sadio Mané,SEN,FW,Liverpool,29,1992,31.3,33,18,7,13,13,8,25,32.0,17,452,143,31.6,57,193,202,36,4,0,32,15,48,10
306,Javier Manquillo,ESP,DF,Newcastle Utd,27,1994,14.0,41,24,27,10,4,19,36,52.8,17,175,56,32.0,100,46,29,28,6,0,22,23,64,29
307,Fernando Marçal,BRA,DF,Wolves,32,1989,16.1,42,26,29,10,3,17,33,51.5,16,241,67,27.8,127,83,31,42,5,0,37,31,73,54
308,Solly March,ENG,"DF,FW",Brighton,27,1994,19.4,38,22,15,9,14,9,24,37.5,15,260,72,27.7,71,82,107,33,4,0,29,31,69,23
309,Pablo Marí,ESP,DF,Arsenal,27,1993,2.0,6,2,2,3,1,4,8,50.0,4,19,4,21.1,9,8,2,6,4,0,2,6,12,11
310,Anthony Martial,FRA,FW,Manchester Utd,25,1995,2.4,1,1,0,0,1,0,1,0.0,1,28,11,39.3,6,9,13,3,0,0,3,1,2,2
311,Martinelli,BRA,"FW,MF",Arsenal,20,2001,20.7,30,19,10,14,6,6,21,28.6,15,341,99,29.0,58,113,170,41,6,0,35,21,51,15
312,Emiliano Martínez,ARG,GK,Aston Villa,28,1992,36.0,0,0,0,0,0,0,2,0.0,2,2,0,0.0,2,0,0,0,0,0,0,1,1,1
313,Adam Masina,MAR,DF,Watford,27,1994,12.0,24,14,11,12,1,10,30,33.3,20,162,45,27.8,73,70,19,29,6,0,23,31,55,41
314,Arthur Masuaku,COD,"DF,FW",West Ham,27,1993,7.2,33,19,20,11,2,12,23,52.2,11,120,39,32.5,61,50,9,10,1,0,9,18,51,16
315,Juan Mata,ESP,MF,Manchester Utd,33,1988,2.6,7,6,2,4,1,3,5,60.0,2,51,15,29.4,17,24,10,1,0,0,1,2,9,2
316,Jean-Philippe Mateta,FRA,FW,Crystal Palace,24,1997,12.7,7,5,1,5,1,3,13,23.1,10,249,50,20.1,22,138,89,12,3,0,9,4,11,15
317,Nemanja Matić,SRB,MF,Manchester Utd,32,1988,15.4,34,28,20,13,1,10,29,34.5,19,232,70,30.2,106,107,19,34,6,0,28,32,66,31
318,Joël Matip,CMR,DF,Liverpool,29,1991,31.0,48,36,24,18,6,17,29,58.6,12,210,89,42.4,117,74,19,38,17,1,21,66,114,121
319,Neal Maupay,FRA,FW,Brighton,24,1996,25.3,19,12,3,9,7,5,14,35.7,9,508,143,28.1,43,186,279,21,3,0,18,10,29,3
320,Bryan Mbeumo,FRA,FW,Brentford,21,1999,32.3,38,25,3,18,17,7,18,38.9,11,505,138,27.3,74,222,209,38,8,0,30,23,61,21
321,James McArthur,SCO,MF,Crystal Palace,33,1987,16.0,37,26,18,17,2,15,40,37.5,25,376,129,34.3,130,197,49,34,9,0,25,34,71,42
322,James Mcatee,ENG,"MF,FW",Manchester City,18,2002,0.2,0,0,0,0,0,0,2,0.0,2,9,2,22.2,2,0,7,0,0,0,0,1,1,0
323,Kasey McAteer,ENG,FW,Leicester City,19,2001,0.0,0,0,0,0,0,0,0,,0,4,1,25.0,0,2,2,0,0,0,0,0,0,0
324,Liam McCarron,SCO,FW,Leeds United,20,2001,0.1,0,0,0,0,0,0,0,,0,3,0,0.0,2,0,1,0,0,0,0,0,0,0
325,Alex McCarthy,ENG,GK,Southampton,31,1989,17.0,0,0,0,0,0,0,0,,0,0,0,,0,0,0,0,0,0,0,0,0,0
326,John McGinn,SCO,MF,Aston Villa,26,1994,34.3,104,61,39,51,14,42,104,40.4,62,560,174,31.1,162,298,100,61,7,0,54,52,156,38
327,Stuart McKinstry,SCO,MF,Leeds United,18,2002,0.0,0,0,0,0,0,0,0,,0,1,1,100.0,1,0,0,0,0,0,0,0,0,0
328,Kenny McLean,SCO,MF,Norwich City,29,1992,30.1,41,24,15,23,3,17,60,28.3,43,516,115,22.3,210,232,74,32,7,0,25,55,96,55
329,Dwight McNeil,ENG,MF,Burnley,21,1999,34.5,68,36,28,32,8,22,74,29.7,52,680,172,25.3,237,288,155,82,12,2,70,67,135,20
330,Scott McTominay,SCO,MF,Manchester Utd,24,1996,26.5,69,33,38,24,7,33,66,50.0,33,490,132,26.9,182,246,62,48,11,0,37,47,116,65
331,Ben Mee,ENG,DF,Burnley,31,1989,20.4,27,16,15,9,3,11,22,50.0,11,109,39,35.8,61,42,6,40,26,1,14,35,62,122
332,Hannibal Mejbri,TUN,FW,Manchester Utd,18,2003,0.8,0,0,0,0,0,0,0,,0,32,6,18.8,6,13,13,0,0,0,0,1,1,0
333,Benjamin Mendy,FRA,DF,Manchester City,27,1994,0.9,3,1,1,1,1,2,4,50.0,2,12,2,16.7,3,8,1,0,0,0,0,0,3,3
334,Edouard Mendy,SEN,GK,Chelsea,29,1992,34.0,0,0,0,0,0,0,2,0.0,2,3,1,33.3,3,0,0,0,0,0,0,0,0,1
335,Nampalys Mendy,SEN,MF,Leicester City,29,1992,11.5,16,12,9,6,1,6,16,37.5,10,155,56,36.1,65,74,16,16,4,0,12,13,29,9
336,Illan Meslier,FRA,GK,Leeds United,21,2000,37.6,0,0,0,0,0,0,0,,0,5,2,40.0,5,0,0,0,0,0,0,0,0,2
337,Luka Milivojević,SRB,MF,Crystal Palace,30,1991,8.6,21,13,10,9,2,13,23,56.5,10,137,45,32.8,56,67,14,9,1,0,8,9,30,21
338,James Milner,ENG,"MF,DF",Liverpool,35,1986,9.5,35,23,15,15,5,15,35,42.9,20,172,68,39.5,37,93,42,20,6,0,14,22,57,22
339,Yerry Mina,COL,DF,Everton,26,1994,9.4,17,12,17,0,0,9,14,64.3,5,70,30,42.9,48,19,3,19,11,1,8,10,27,47
340,Takumi Minamino,JPN,"FW,MF",Liverpool,26,1995,2.1,3,2,1,1,1,2,11,18.2,9,64,22,34.4,4,34,26,1,0,0,1,3,6,1
341,Tyrone Mings,ENG,DF,Aston Villa,28,1993,35.4,36,21,23,8,5,11,21,52.4,10,203,66,32.5,113,67,23,70,34,3,36,78,114,181
342,Tyrick Mitchell,ENG,DF,Crystal Palace,21,1999,34.5,108,54,74,24,10,43,65,66.2,22,683,218,31.9,394,189,100,76,6,0,70,79,187,85
343,Jakub Moder,POL,"MF,FW",Brighton,22,1999,18.9,42,29,19,14,9,18,40,45.0,22,361,116,32.1,118,135,108,31,2,0,29,22,64,26
344,Wesley Moraes,BRA,FW,Aston Villa,24,1996,0.0,0,0,0,0,0,0,0,,0,2,1,50.0,1,0,1,0,0,0,0,0,0,0
345,Tyler Morton,ENG,MF,Liverpool,18,2002,0.7,0,0,0,0,0,0,2,0.0,2,12,4,33.3,1,9,2,0,0,0,0,2,2,0
346,Mason Mount,ENG,"MF,FW",Chelsea,22,1999,26.3,43,29,10,18,15,11,33,33.3,22,528,161,30.5,86,208,234,23,2,0,21,20,63,11
347,Lucas Moura,BRA,"FW,MF",Tottenham,28,1992,19.7,29,14,6,16,7,6,26,23.1,20,278,68,24.5,66,140,72,18,1,0,17,22,51,21
348,João Moutinho,POR,MF,Wolves,34,1986,33.0,76,54,37,29,10,27,98,27.6,71,608,186,30.6,232,318,58,52,8,0,44,48,124,35
349,Bali Mumba,ENG,DF,Norwich City,19,2001,0.5,1,0,1,0,0,0,0,,0,12,3,25.0,10,2,0,2,0,0,2,1,2,5
350,Jacob Murphy,ENG,"FW,DF",Newcastle Utd,26,1995,16.4,41,17,27,11,3,15,35,42.9,20,320,71,22.2,136,106,78,31,2,0,29,33,74,20
351,Enock Mwepu,ZAM,"MF,FW",Brighton,23,1998,11.1,25,14,8,12,5,7,29,24.1,22,223,57,25.6,63,93,67,24,4,0,20,16,41,19
352,Vitaliy Mykolenko,UKR,DF,Everton,22,1999,11.7,28,14,16,9,3,12,26,46.2,14,172,43,25.0,88,58,26,34,2,0,32,25,53,31
353,Marvelous Nakamba,ZIM,MF,Aston Villa,27,1994,10.0,31,19,19,11,1,14,35,40.0,21,209,59,28.2,107,86,16,16,4,0,12,23,54,16
354,Wilfred Ndidi,NGA,"MF,DF",Leicester City,24,1996,18.0,70,47,39,28,3,21,47,44.7,26,410,137,33.4,155,214,41,32,6,0,26,45,115,69
355,Tanguy Ndombele,FRA,MF,Tottenham,24,1996,5.4,13,10,4,8,1,1,6,16.7,5,88,26,29.5,24,45,19,2,1,0,1,3,16,3
356,Reiss Nelson,ENG,FW,Arsenal,21,1999,0.2,1,0,0,1,0,0,0,,0,8,2,25.0,2,5,1,0,0,0,0,1,2,0
357,Pedro Neto,POR,"FW,MF",Wolves,21,2000,5.2,5,5,2,2,1,0,7,0.0,7,90,22,24.4,18,38,34,1,0,0,1,6,11,1
358,Rúben Neves,POR,MF,Wolves,24,1997,29.6,67,43,32,29,6,22,90,24.4,68,541,145,26.8,203,288,50,43,6,0,37,55,122,54
359,Jeremy Ngakia,ENG,DF,Watford,20,2000,10.0,41,21,34,4,3,20,33,60.6,13,202,55,27.2,139,48,15,16,3,0,13,29,70,20
360,Saúl Ñíguez,ESP,"MF,DF",Chelsea,26,1994,5.3,15,8,7,6,2,6,15,40.0,9,103,29,28.2,43,48,12,13,3,0,10,14,29,7
361,Eddie Nketiah,ENG,FW,Arsenal,22,1999,9.3,12,7,0,7,5,1,3,33.3,2,178,50,28.1,11,62,105,7,2,0,5,6,18,7
362,Nicolas Nkoulou,CMR,DF,Watford,31,1990,1.9,1,0,0,1,0,0,0,,0,7,5,71.4,5,2,0,5,2,0,3,1,2,10
363,Mark Noble,ENG,MF,West Ham,34,1987,3.7,11,7,9,2,0,2,4,50.0,2,53,21,39.6,23,23,7,4,1,0,3,5,16,3
364,Mathias Normann,NOR,MF,Norwich City,25,1996,18.3,38,24,21,14,3,11,35,31.4,24,324,66,20.4,144,156,24,26,11,1,15,25,63,43
365,Christian Nørgaard,DEN,MF,Brentford,27,1994,33.9,130,80,54,64,12,54,105,51.4,51,691,218,31.5,260,366,65,59,10,1,49,85,215,57
366,Angelo Ogbonna,ITA,DF,West Ham,33,1988,10.2,13,8,8,5,0,2,7,28.6,5,50,16,32.0,32,15,3,7,4,0,3,13,26,38
367,Michael Olise,FRA,"FW,MF",Crystal Palace,19,2001,12.7,22,15,9,8,5,9,20,45.0,11,240,68,28.3,70,115,55,22,0,0,22,13,35,9
368,Robin Olsen,SWE,GK,Aston Villa,31,1990,1.0,0,0,0,0,0,0,0,,0,0,0,,0,0,0,0,0,0,0,0,0,0
369,Andrew Omobamidele,IRL,DF,Norwich City,19,2002,4.2,8,3,5,3,0,6,12,50.0,6,49,14,28.6,37,12,0,10,10,0,0,10,18,17
370,Tyler Onyango,ENG,"MF,FW",Everton,18,2003,0.3,1,0,1,0,0,0,1,0.0,1,10,2,20.0,6,3,1,0,0,0,0,1,2,0
371,Frank Onyeka,NGA,MF,Brentford,23,1998,11.6,30,16,14,12,4,5,20,25.0,15,253,69,27.3,109,106,38,20,2,0,18,15,45,13
372,Divock Origi,BEL,FW,Liverpool,26,1995,1.5,0,0,0,0,0,0,3,0.0,3,29,5,17.2,2,16,11,2,0,0,2,3,3,1
373,Alex Oxlade-Chamberlain,ENG,"MF,FW",Liverpool,27,1993,8.7,17,14,3,7,7,5,13,38.5,8,172,63,36.6,26,76,70,11,3,0,8,8,25,7
374,Cole Palmer,ENG,"FW,MF",Manchester City,19,2002,1.4,2,2,1,1,0,0,1,0.0,1,29,6,20.7,3,11,15,2,0,0,2,2,4,0
375,Emerson Palmieri,ITA,DF,Chelsea,26,1994,0.1,0,0,0,0,0,0,0,,0,0,0,,0,0,0,0,0,0,0,0,0,0
376,Thomas Partey,GHA,MF,Arsenal,28,1993,22.5,55,41,25,23,7,18,41,43.9,23,291,103,35.4,107,148,36,28,5,0,23,33,88,32
377,João Pedro,BRA,"FW,MF",Watford,19,2001,18.3,22,17,5,11,6,4,16,25.0,12,337,108,32.0,52,159,126,28,5,1,23,19,41,18
378,Nicolas Pépé,CIV,"FW,MF",Arsenal,26,1995,7.7,14,11,7,5,2,2,9,22.2,7,122,35,28.7,36,45,41,13,1,0,12,9,23,3
379,Ricardo Pereira,POR,DF,Leicester City,27,1993,11.0,45,25,24,15,6,20,39,51.3,19,194,62,32.0,76,81,37,27,4,0,23,25,70,32
380,Ayoze Pérez,ESP,"MF,FW",Leicester City,28,1993,4.9,8,6,2,5,1,2,11,18.2,9,128,33,25.8,31,62,35,11,2,0,9,9,17,3
381,Sonny Perkins,ENG,FW,West Ham,17,2004,0.0,0,0,0,0,0,0,0,,0,1,1,100.0,0,1,0,0,0,0,0,0,0,0
382,Romain Perraud,FRA,DF,Southampton,23,1997,18.0,38,20,19,14,5,16,28,57.1,12,325,85,26.2,146,108,71,30,7,1,23,24,62,46
383,Kalvin Phillips,ENG,MF,Leeds United,25,1995,17.7,65,43,27,33,5,18,48,37.5,30,504,149,29.6,163,261,80,42,10,0,32,34,99,30
384,Jaden Philogene Bidace,ENG,FW,Aston Villa,19,2002,0.1,0,0,0,0,0,0,0,,0,2,0,0.0,1,1,0,0,0,0,0,0,0,0
385,Jordan Pickford,ENG,GK,Everton,27,1994,35.0,1,0,1,0,0,0,1,0.0,1,7,1,14.3,7,0,0,2,0,0,2,0,1,1
386,Erik Pieters,NED,DF,Burnley,32,1988,8.1,28,16,22,5,1,16,35,45.7,19,143,40,28.0,75,53,15,25,7,0,18,23,51,27
387,Ethan Pinnock,JAM,DF,Brentford,28,1993,29.9,63,38,46,15,2,20,36,55.6,16,281,102,36.3,167,94,20,49,13,0,36,56,119,175
388,Daniel Podence,POR,"FW,MF",Wolves,25,1995,16.5,19,9,9,6,4,8,21,38.1,13,247,67,27.1,49,101,97,13,2,0,11,6,25,0
389,Paul Pogba,FRA,"MF,FW",Manchester Utd,28,1993,15.0,20,13,9,9,2,5,19,26.3,14,264,76,28.8,61,127,76,16,1,0,15,19,39,25
390,Nick Pope,ENG,GK,Burnley,29,1992,36.0,0,0,0,0,0,0,2,0.0,2,1,1,100.0,1,0,0,0,0,0,0,0,0,4
391,Isaac Price,NIR,MF,Everton,17,2003,0.2,1,0,0,1,0,1,1,100.0,0,8,1,12.5,4,3,1,1,0,0,1,1,2,0
392,Teemu Pukki,FIN,FW,Norwich City,31,1990,36.1,24,11,1,14,9,3,16,18.8,13,702,175,24.9,40,289,373,21,2,0,19,17,41,4
393,Christian Pulisic,USA,"MF,FW",Chelsea,22,1998,14.3,18,9,5,11,2,2,12,16.7,10,294,72,24.5,47,124,123,18,0,0,18,11,29,9
394,Przemysław Płacheta,POL,"FW,MF",Norwich City,23,1998,5.6,5,3,5,0,0,0,4,0.0,4,115,25,21.7,34,55,26,7,1,0,6,9,14,5
395,Jesuran Rak Sakyi,ENG,"FW,MF",Crystal Palace,18,2002,0.9,0,0,0,0,0,0,1,0.0,1,20,2,10.0,3,9,8,2,0,0,2,3,3,0
396,Aaron Ramsdale,ENG,GK,Arsenal,23,1998,34.0,0,0,0,0,0,0,3,0.0,3,3,0,0.0,3,0,0,0,0,0,0,0,0,2
397,Jacob Ramsey,ENG,MF,Aston Villa,20,2001,27.4,66,41,35,27,4,22,59,37.3,37,547,148,27.1,186,258,103,41,7,0,34,38,104,27
398,Marcus Rashford,ENG,"FW,MF",Manchester Utd,23,1997,13.7,8,6,2,5,1,3,17,17.6,14,254,76,29.9,41,115,98,11,1,0,10,12,20,6
399,Milot Rashica,KVX,"FW,MF",Norwich City,25,1996,24.8,33,21,15,13,5,14,34,41.2,20,328,93,28.4,114,111,103,27,3,0,24,36,69,20
400,David Raya,ESP,GK,Brentford,25,1995,24.0,0,0,0,0,0,0,1,0.0,1,1,0,0.0,1,0,0,1,0,0,1,0,0,0
401,Nathan Redmond,ENG,"MF,FW",Southampton,27,1994,20.4,20,13,6,10,4,5,22,22.7,17,364,100,27.5,90,144,130,34,2,0,32,21,41,18
402,Sergio Reguilón,ESP,DF,Tottenham,24,1996,21.3,47,28,22,19,6,23,39,59.0,16,298,89,29.9,117,131,50,32,7,0,25,42,89,43
403,Declan Rice,ENG,MF,West Ham,22,1999,35.3,77,53,44,29,4,28,60,46.7,32,476,154,32.4,215,224,37,60,25,1,35,95,172,53
404,Taylor Richards,ENG,"MF,FW",Brighton,20,2000,0.3,0,0,0,0,0,0,2,0.0,2,10,5,50.0,5,5,0,0,0,0,0,0,0,0
405,Richarlison,BRA,"FW,MF",Everton,24,1997,28.0,40,27,14,14,12,13,25,52.0,12,590,144,24.4,89,237,264,48,5,0,43,21,61,32
406,Jaïro Riedewald,NED,MF,Crystal Palace,24,1996,1.3,2,2,0,1,1,2,4,50.0,2,11,3,27.3,7,2,2,4,0,0,4,0,2,2
407,Matt Ritchie,SCO,DF,Newcastle Utd,31,1989,14.9,22,7,11,8,3,13,30,43.3,17,153,47,30.7,76,55,22,28,2,0,26,30,52,26
408,Connor Roberts,WAL,DF,Burnley,25,1995,18.8,21,13,11,7,3,8,16,50.0,8,157,46,29.3,72,62,23,49,8,0,41,42,63,55
409,Tyler Roberts,WAL,"MF,FW",Leeds United,22,1999,11.0,17,7,7,6,4,9,15,60.0,6,169,44,26.0,24,85,60,10,1,0,9,7,24,8
410,Andrew Robertson,SCO,DF,Liverpool,27,1994,28.2,33,17,14,14,5,14,34,41.2,20,284,86,30.3,85,115,84,43,4,1,39,49,82,58
411,Joe Rodon,WAL,DF,Tottenham,23,1997,1.0,0,0,0,0,0,0,0,,0,7,3,42.9,5,2,0,3,2,0,1,2,2,8
412,Rodri,ESP,MF,Manchester City,25,1996,32.0,65,46,20,36,9,29,61,47.5,32,481,171,35.6,130,254,97,48,6,1,42,40,105,54
413,Rodrigo,ESP,"MF,FW",Leeds United,30,1991,25.2,26,18,5,12,9,9,26,34.6,17,417,118,28.3,66,183,168,15,1,0,14,19,45,27
414,Jay Rodriguez,ENG,FW,Burnley,32,1989,15.4,22,10,9,8,5,3,15,20.0,12,330,70,21.2,74,114,142,25,3,0,22,6,28,12
415,Mads Roerslev,DEN,DF,Brentford,22,1999,13.8,26,9,23,1,2,16,35,45.7,19,173,43,24.9,114,40,19,31,6,0,25,21,47,30
416,Cristian Romero,ARG,DF,Tottenham,23,1998,20.5,75,45,43,30,2,25,43,58.1,18,317,113,35.6,195,98,24,50,23,0,27,57,132,78
417,Oriol Romeu,ESP,MF,Southampton,29,1991,32.1,81,54,23,47,11,23,77,29.9,54,564,191,33.9,181,309,74,45,9,0,36,67,148,52
418,Cristiano Ronaldo,POR,FW,Manchester Utd,36,1985,27.3,10,8,2,5,3,4,7,57.1,3,182,49,26.9,23,77,82,12,2,0,10,5,15,31
419,Salomón Rondón,VEN,FW,Everton,31,1989,8.8,6,2,0,3,3,3,10,30.0,7,172,50,29.1,17,75,80,6,1,0,5,4,10,11
420,Danny Rose,ENG,DF,Watford,31,1990,7.7,23,15,15,8,0,12,29,41.4,17,85,34,40.0,44,36,5,14,6,0,8,15,38,13
421,Jon Rowe,ENG,"FW,MF",Norwich City,18,2003,2.5,7,3,3,3,1,1,1,100.0,0,67,16,23.9,15,28,24,7,0,0,7,4,11,0
422,John Ruddy,ENG,GK,Wolves,34,1986,1.5,0,0,0,0,0,0,0,,0,0,0,,0,0,0,0,0,0,0,0,0,0
423,Antonio Rüdiger,GER,DF,Chelsea,28,1993,33.7,53,28,30,21,2,30,46,65.2,16,294,92,31.3,146,115,33,41,13,0,28,43,96,110
424,Lukas Rupp,GER,MF,Norwich City,30,1991,8.5,10,8,5,5,0,4,14,28.6,10,172,53,30.8,75,73,24,8,1,0,7,17,27,4
425,José Sá,POR,GK,Wolves,28,1993,36.5,1,0,1,0,0,1,3,33.3,2,10,3,30.0,10,0,0,1,0,0,1,0,1,3
426,Allan Saint-Maximin,FRA,"FW,MF",Newcastle Utd,24,1997,31.2,9,6,4,2,3,2,18,11.1,16,256,67,26.2,52,109,95,17,1,0,16,21,30,2
427,Romain Saïss,MAR,DF,Wolves,31,1990,30.1,60,38,40,17,3,18,32,56.3,14,283,103,36.4,162,101,20,61,24,0,37,81,141,173
428,Bukayo Saka,ENG,"FW,MF",Arsenal,19,2001,33.1,37,23,13,14,10,7,31,22.6,24,496,134,27.0,110,188,198,41,2,0,39,31,68,19
429,Mohamed Salah,EGY,FW,Liverpool,29,1992,30.7,17,7,5,7,5,4,21,19.0,17,448,127,28.3,67,127,254,13,1,0,12,15,32,4
430,Mohammed Salisu,GHA,DF,Southampton,22,1999,33.0,91,60,63,25,3,41,72,56.9,31,364,148,40.7,218,123,23,69,28,1,41,93,184,196
431,Albert Sambi Lokonga,BEL,MF,Arsenal,21,1999,12.6,22,13,9,10,3,9,15,60.0,6,138,47,34.1,45,64,29,18,8,0,10,23,45,18
432,Davinson Sánchez,COL,DF,Tottenham,25,1996,18.1,45,22,24,17,4,16,27,59.3,11,186,66,35.5,89,80,17,35,19,0,16,34,79,76
433,Robert Sánchez,ESP,GK,Brighton,23,1997,37.0,0,0,0,0,0,0,0,,0,5,1,20.0,5,0,0,2,0,0,2,0,0,0
434,Jadon Sancho,ENG,"FW,MF",Manchester Utd,21,2000,21.1,18,13,8,8,2,7,23,30.4,16,276,68,24.6,65,128,83,28,2,0,26,24,42,5
435,Morgan Sanson,FRA,MF,Aston Villa,26,1994,4.0,12,8,5,4,3,4,6,66.7,2,135,46,34.1,51,60,24,15,0,0,15,11,23,2
436,Samir Santos,BRA,DF,Watford,26,1994,18.6,32,19,21,10,1,10,17,58.8,7,143,53,37.1,98,38,7,28,11,1,17,54,86,82
