,Player,Nation,Pos,Squad,Age,Born,90s,Tackles Tkl,Tackles TklW,Tackles Def 3rd,Tackles Mid 3rd,Tackles Att 3rd,Vs Dribbles Tkl,Vs Dribbles Att,Vs Dribbles Tkl%,Vs Dribbles Past,Pressures Press,Pressures Succ%,Pressures Def 3rd,Pressures Mid 3rd,Pressures Att 3rd,Blocks,Sh,ShSv,Pass,Int,Tkl+Int,Clr,Er
0,Max Aarons,ENG,DF,Norwich City,21-297,2000,9.0,12,8,7,5,0,8,18,44.4,10,107,27,25.2,62,34,11,25,6,0,19,8,20,22
1,Che Adams,SCO,"FW,MF",Southampton,25-107,1996,4.4,7,5,2,1,4,1,2,50.0,1,72,22,30.6,8,25,39,5,2,0,3,1,8,5
2,Rayan Aït Nouri,FRA,"DF,FW",Wolves,20-144,2001,1.0,5,5,3,1,1,2,3,66.7,1,22,9,40.9,9,8,5,2,0,0,2,2,7,2
3,Kristoffer Ajer,NOR,DF,Brentford,23-194,1998,6.3,11,5,8,1,2,7,14,50.0,7,57,18,31.6,29,24,4,9,4,1,5,13,24,35
4,Nathan Aké,NED,DF,Manchester City,26-252,1995,3.0,4,2,2,2,0,0,1,0.0,1,14,4,28.6,4,9,1,3,3,0,0,3,7,17
5,Marc Albrighton,ENG,"MF,FW",Leicester City,31-344,1989,2.1,4,1,3,0,1,0,3,0.0,3,68,12,17.6,22,36,10,2,0,0,2,1,5,1
6,Thiago Alcántara,ESP,MF,Liverpool,30-200,1991,2.0,7,4,4,2,1,1,3,33.3,2,21,10,47.6,11,6,4,1,0,0,1,2,9,3
7,Trent Alexander-Arnold,ENG,DF,Liverpool,23-021,1998,6.7,13,9,4,6,3,8,17,47.1,9,66,22,33.3,28,22,16,9,2,0,7,17,30,14
8,Alisson,BRA,GK,Liverpool,29-026,1992,8.0,0,0,0,0,0,0,0,,0,1,0,0.0,1,0,0,0,0,0,0,0,0,1
9,Allan,BRA,MF,Everton,30-293,1991,8.8,29,24,18,9,2,7,30,23.3,23,235,77,32.8,107,111,17,20,4,0,16,18,47,20
10,Dele Alli,ENG,MF,Tottenham,25-200,1996,5.5,18,8,12,5,1,6,15,40.0,9,145,38,26.2,64,56,25,18,5,0,13,11,29,8
11,Miguel Almirón,PAR,MF,Newcastle Utd,27-260,1994,6.7,19,12,12,4,3,4,16,25.0,12,137,42,30.7,58,54,25,9,1,1,8,9,28,4
12,Marcos Alonso,ESP,DF,Chelsea,30-304,1990,5.9,13,6,7,3,3,5,10,50.0,5,72,19,26.4,31,24,17,12,1,0,11,13,26,15
13,Steven Alzate,COL,MF,Brighton,23-050,1998,1.0,2,2,1,0,1,1,1,100.0,0,14,3,21.4,8,4,2,2,0,0,2,1,3,2
14,Daniel Amartey,GHA,DF,Leicester City,26-311,1994,5.0,4,2,2,2,0,3,6,50.0,3,34,11,32.4,23,10,1,8,4,0,4,6,10,20
15,Joachim Andersen,DEN,DF,Crystal Palace,25-150,1996,8.4,8,5,6,2,0,4,7,57.1,3,34,11,32.4,17,15,2,10,4,0,6,20,28,49
16,Michail Antonio,JAM,FW,West Ham,31-214,1990,7.9,11,9,0,5,6,2,3,66.7,1,114,41,36.0,7,46,61,7,0,0,7,5,16,3
17,Cameron Archer,ENG,"MF,FW",Aston Villa,20-099,2001,0.1,0,0,0,0,0,0,0,,0,1,0,0.0,0,1,0,0,0,0,0,0,0,1
18,Adam Armstrong,ENG,FW,Southampton,24-260,1997,6.8,4,3,1,0,3,0,2,0.0,2,118,34,28.8,10,47,61,3,1,0,2,1,5,0
19,Stuart Armstrong,SCO,MF,Southampton,29-212,1992,0.5,0,0,0,0,0,0,3,0.0,3,15,5,33.3,2,9,4,1,0,0,1,1,1,1
20,Kepa Arrizabalaga,ESP,GK,Chelsea,27-025,1994,1.0,0,0,0,0,0,0,0,,0,1,0,0.0,1,0,0,0,0,0,0,0,0,0
21,Pierre-Emerick Aubameyang,GAB,FW,Arsenal,32-132,1989,6.8,8,4,4,2,2,1,3,33.3,2,120,30,25.0,15,42,63,10,1,0,9,0,8,1
22,Jordan Ayew,GHA,"FW,MF",Crystal Palace,30-047,1991,6.5,13,8,6,6,1,4,8,50.0,4,149,34,22.8,31,63,55,17,2,0,15,10,23,2
23,Luke Ayling,ENG,DF,Leeds United,30-064,1991,5.0,13,5,11,2,0,7,14,50.0,7,71,23,32.4,38,23,10,11,8,0,3,6,19,11
24,César Azpilicueta,ESP,DF,Chelsea,32-061,1989,7.0,19,8,10,6,3,6,15,40.0,9,101,25,24.8,45,39,17,20,3,0,17,8,27,21
25,Daniel Bachmann,AUT,GK,Watford,27-111,1994,4.0,0,0,0,0,0,0,0,,0,0,0,,0,0,0,0,0,0,0,0,0,0
26,Leon Bailey,JAM,"FW,MF",Aston Villa,24-080,1997,1.5,4,1,1,3,0,0,2,0.0,2,14,3,21.4,3,5,6,2,0,0,2,0,4,0
27,Folarin Balogun,ENG,FW,Arsenal,20-117,2001,0.8,0,0,0,0,0,0,0,,0,21,5,23.8,2,2,17,1,0,0,1,0,0,1
28,Patrick Bamford,ENG,FW,Leeds United,28-053,1993,4.8,2,1,1,1,0,1,3,33.3,2,92,31,33.7,4,39,49,6,3,0,3,3,5,8
29,Shandon Baptiste,GRN,MF,Brentford,23-203,1998,2.1,3,2,3,0,0,0,0,,0,52,18,34.6,16,23,13,6,0,0,6,4,7,3
30,Ross Barkley,ENG,MF,Chelsea,27-327,1993,0.3,1,1,0,1,0,0,1,0.0,1,5,3,60.0,0,2,3,1,0,0,1,0,1,0
31,Ashley Barnes,ENG,FW,Burnley,31-363,1989,4.2,6,5,1,4,1,1,2,50.0,1,63,11,17.5,6,31,26,3,1,1,2,3,9,1
32,Harvey Barnes,ENG,"FW,MF",Leicester City,23-323,1997,6.0,5,2,1,3,1,1,6,16.7,5,53,17,32.1,17,22,14,6,1,0,5,2,7,3
33,Mads Bech Sørensen,DEN,DF,Brentford,22-294,1999,0.2,1,1,1,0,0,0,0,,0,4,2,50.0,4,0,0,0,0,0,0,0,1,1
34,Jan Bednarek,POL,DF,Southampton,25-199,1996,5.5,11,6,6,4,1,3,10,30.0,7,46,16,34.8,24,20,2,8,5,0,3,20,31,32
35,Donny van de Beek,NED,MF,Manchester Utd,24-193,1997,0.1,0,0,0,0,0,0,0,,0,0,0,,0,0,0,0,0,0,0,0,0,0
36,Asmir Begović,BIH,GK,Everton,34-130,1987,1.0,0,0,0,0,0,0,0,,0,0,0,,0,0,0,0,0,0,0,0,0,1
37,Saïd Benrahma,ALG,"MF,FW",West Ham,26-079,1995,8.5,14,9,5,6,3,8,16,50.0,8,128,33,25.8,25,75,28,3,0,0,3,3,17,2
38,Christian Benteke,BEL,FW,Crystal Palace,30-329,1990,6.3,4,1,1,2,1,0,3,0.0,3,56,12,21.4,6,27,23,4,3,0,1,1,5,13
39,Jóhann Berg Guðmundsson,ISL,MF,Burnley,31-001,1990,5.2,6,3,2,3,1,3,5,60.0,2,61,20,32.8,15,22,24,11,2,0,9,4,10,5
40,Steven Bergwijn,NED,FW,Tottenham,24-020,1997,2.6,2,1,1,1,0,0,1,0.0,1,30,2,6.7,7,15,8,3,0,0,3,2,4,5
41,Ryan Bertrand,ENG,DF,Leicester City,32-084,1989,3.7,9,4,1,7,1,4,6,66.7,2,77,25,32.5,40,26,11,11,3,0,8,3,12,7
42,Mads Bidstrup,DEN,MF,Brentford,20-245,2001,0.3,4,2,2,2,0,0,2,0.0,2,12,6,50.0,7,5,0,1,0,0,1,1,5,2
43,Yves Bissouma,MLI,MF,Brighton,25-059,1996,4.9,16,12,12,2,2,3,3,100.0,0,85,36,42.4,33,39,13,4,0,0,4,10,26,5
44,Jarrod Bowen,ENG,FW,West Ham,24-312,1996,8.7,17,11,9,5,3,3,9,33.3,6,128,31,24.2,42,45,41,11,2,0,9,10,27,1
45,Armando Broja,ALB,"FW,MF",Southampton,20-048,2001,2.7,4,4,0,2,2,1,3,33.3,2,52,15,28.8,4,11,37,2,0,0,2,2,6,2
46,Josh Brownhill,ENG,MF,Burnley,25-313,1995,8.1,12,10,4,6,2,1,6,16.7,5,116,39,33.6,35,54,27,7,3,0,4,13,25,14
47,Bryan,ESP,"FW,MF",Tottenham,20-259,2001,0.7,2,1,2,0,0,2,4,50.0,2,27,7,25.9,9,5,13,2,0,0,2,0,2,0
48,Emi Buendía,ARG,"MF,FW",Aston Villa,24-307,1996,4.7,12,7,5,5,2,2,13,15.4,11,86,23,26.7,24,40,22,3,0,0,3,4,16,3
49,Dan Burn,ENG,DF,Brighton,29-172,1992,3.4,11,8,7,3,1,4,10,40.0,6,54,18,33.3,20,25,9,9,2,0,7,8,19,10
50,Dominic Calvert-Lewin,ENG,FW,Everton,24-226,1997,2.8,0,0,0,0,0,0,1,0.0,1,20,3,15.0,2,11,7,1,1,0,0,5,5,2
51,João Cancelo,POR,DF,Manchester City,27-154,1994,9.0,20,12,11,8,1,6,18,33.3,12,90,24,26.7,32,32,26,15,1,0,14,28,48,19
52,Sergi Canós,ESP,DF,Brentford,24-268,1997,8.2,22,7,13,6,3,9,20,45.0,11,170,41,24.1,87,58,25,17,1,0,16,13,35,15
53,Todd Cantwell,ENG,"FW,MF",Norwich City,23-243,1998,3.5,13,10,8,4,1,4,13,30.8,9,75,15,20.0,31,29,15,1,0,0,1,3,16,1
54,Matty Cash,POL,DF,Aston Villa,24-082,1997,8.8,19,15,8,10,1,10,19,52.6,9,111,36,32.4,38,57,16,12,1,0,11,15,34,18
55,Timothy Castagne,BEL,DF,Leicester City,25-327,1995,5.6,17,7,8,7,2,7,13,53.8,6,123,30,24.4,54,54,15,11,1,0,10,9,26,16
56,Craig Cathcart,NIR,DF,Watford,32-264,1989,6.3,5,3,5,0,0,1,6,16.7,5,42,16,38.1,28,11,3,13,4,0,9,10,15,27
57,Edinson Cavani,URU,FW,Manchester Utd,34-256,1987,1.5,1,1,0,1,0,1,1,100.0,0,11,3,27.3,1,6,4,1,0,0,1,5,6,0
58,Trevoh Chalobah,ENG,DF,Chelsea,22-115,1999,5.0,14,7,6,6,2,8,13,61.5,5,56,18,32.1,27,27,2,7,4,1,3,7,21,19
59,Calum Chambers,ENG,DF,Arsenal,26-281,1995,1.9,2,1,2,0,0,1,3,33.3,2,24,5,20.8,18,5,1,11,3,0,8,3,5,7
60,Ben Chilwell,ENG,DF,Chelsea,24-311,1996,3.0,8,5,3,4,1,1,2,50.0,1,52,18,34.6,17,21,14,5,0,0,5,5,13,10
61,Hamza Choudhury,ENG,MF,Leicester City,24-027,1997,0.7,4,1,0,4,0,2,2,100.0,0,16,2,12.5,0,13,3,1,0,0,1,6,10,2
62,Andreas Christensen,DEN,DF,Chelsea,25-201,1996,6.0,7,6,5,1,1,3,5,60.0,2,51,20,39.2,30,20,1,16,4,0,12,26,33,40
63,Carney Chukwuemeka,ENG,MF,Aston Villa,17-294,2004,0.7,0,0,0,0,0,0,2,0.0,2,8,1,12.5,1,7,0,0,0,0,0,1,1,0
64,Ciaran Clark,IRL,DF,Newcastle Utd,32-032,1989,6.9,13,10,8,4,1,8,14,57.1,6,53,18,34.0,39,11,3,10,7,0,3,9,22,37
65,Tom Cleverley,ENG,"MF,FW",Watford,32-077,1989,4.0,8,6,3,5,0,2,6,33.3,4,70,23,32.9,15,39,16,7,4,1,3,4,12,2
66,Conor Coady,ENG,DF,Wolves,28-245,1993,9.0,8,6,5,3,0,5,9,55.6,4,47,20,42.6,34,11,2,11,8,0,3,12,20,34
67,Séamus Coleman,IRL,DF,Everton,33-017,1988,6.0,10,7,6,3,1,9,16,56.3,7,62,19,30.6,32,26,4,11,2,0,9,10,20,15
68,Nathan Collins,IRL,DF,Burnley,20-181,2001,3.0,9,6,8,1,0,1,3,33.3,2,27,10,37.0,20,5,2,7,3,0,4,7,16,13
69,Aaron Connolly,IRL,FW,Brighton,21-273,2000,0.7,0,0,0,0,0,0,0,,0,18,3,16.7,1,8,9,0,0,0,0,0,0,0
70,Liam Cooper,SCO,DF,Leeds United,30-059,1991,9.0,18,9,12,5,1,6,11,54.5,5,96,39,40.6,56,37,3,16,11,0,5,17,35,57
71,Jack Cork,ENG,MF,Burnley,32-125,1989,3.5,4,3,0,2,2,2,6,33.3,4,52,14,26.9,12,26,14,4,0,0,4,5,9,5
72,Maxwel Cornet,CIV,"MF,FW",Burnley,25-031,1996,2.3,2,2,1,0,1,0,2,0.0,2,24,7,29.2,2,10,12,1,1,0,0,5,7,1
73,Hélder Costa,POR,MF,Leeds United,27-289,1994,0.2,0,0,0,0,0,0,2,0.0,2,9,2,22.2,1,5,3,0,0,0,0,0,0,0
74,Vladimír Coufal,CZE,DF,West Ham,29-067,1992,7.0,17,9,9,6,2,5,9,55.6,4,93,29,31.2,43,37,13,13,2,0,11,6,23,19
75,Aaron Cresswell,ENG,DF,West Ham,31-317,1989,9.0,12,6,8,3,1,5,8,62.5,3,59,21,35.6,34,21,4,14,4,0,10,5,17,22
76,Charlie Cresswell,ENG,DF,Leeds United,18-325,2002,1.0,4,2,2,2,0,1,2,50.0,1,19,5,26.3,9,10,0,1,1,0,0,2,6,5
77,Cucho,COL,"FW,MF",Watford,22-191,1999,3.5,4,1,2,2,0,1,8,12.5,7,75,16,21.3,23,30,22,6,0,0,6,2,6,0
78,Marc Cucurella,ESP,DF,Brighton,23-098,1998,5.6,14,8,4,7,3,6,8,75.0,2,108,31,28.7,39,46,23,16,1,0,15,8,22,4
79,Patson Daka,ZAM,"FW,MF",Leicester City,23-019,1998,1.0,1,0,0,1,0,0,0,,0,16,4,25.0,1,10,5,2,0,0,2,1,2,1
80,Stuart Dallas,NIR,"DF,MF",Leeds United,30-192,1991,8.9,14,5,10,4,0,7,24,29.2,17,120,36,30.0,57,47,16,9,3,0,6,16,30,25
81,Diogo Dalot,POR,"DF,FW",Manchester Utd,22-224,1999,1.0,1,0,1,0,0,0,1,0.0,1,8,1,12.5,3,3,2,1,0,0,1,3,4,3
82,Karl Darlow,ENG,GK,Newcastle Utd,31-020,1990,5.0,0,0,0,0,0,0,0,,0,0,0,,0,0,0,0,0,0,0,0,0,1
83,Ben Davies,WAL,DF,Tottenham,28-187,1993,0.3,1,1,0,1,0,0,0,,0,3,1,33.3,1,1,1,1,1,0,0,0,1,1
84,Tom Davies,ENG,MF,Everton,23-120,1998,1.4,4,2,1,2,1,1,2,50.0,1,36,8,22.2,15,15,6,3,0,0,3,4,8,2
85,Craig Dawson,ENG,DF,West Ham,31-175,1990,4.2,2,1,2,0,0,1,3,33.3,2,30,10,33.3,16,12,2,7,5,0,2,4,6,26
86,Kevin De Bruyne,BEL,MF,Manchester City,30-122,1991,3.4,2,1,0,2,0,0,3,0.0,3,37,11,29.7,10,12,15,4,2,0,2,1,3,4
87,Troy Deeney,ENG,FW,Watford,33-121,1988,0.3,0,0,0,0,0,0,1,0.0,1,7,2,28.6,1,2,4,0,0,0,0,0,0,3
88,Fabian Delph,ENG,MF,Everton,31-341,1989,0.1,3,3,2,1,0,2,2,100.0,0,6,5,83.3,4,2,0,1,0,0,1,1,4,0
89,Leander Dendoncker,BEL,"MF,FW",Wolves,26-196,1995,3.5,6,3,3,3,0,1,6,16.7,5,66,21,31.8,28,27,11,9,2,0,7,3,9,8
90,Emmanuel Dennis,NGA,"FW,MF",Watford,23-347,1997,7.4,18,8,10,5,3,5,17,29.4,12,176,38,21.6,42,79,55,11,1,0,10,5,23,2
91,Kiernan Dewsbury Hall,ENG,MF,Leicester City,23-052,1998,0.1,0,0,0,0,0,0,0,,0,0,0,,0,0,0,0,0,0,0,0,0,1
92,Ibrahima Diallo,FRA,MF,Southampton,22-234,1999,3.3,3,3,1,1,1,1,7,14.3,6,76,23,30.3,22,45,9,0,0,0,0,1,4,1
93,Raphael Dias Belloli,BRA,"MF,FW",Leeds United,24-318,1996,7.1,14,6,9,3,2,5,8,62.5,3,103,25,24.3,26,45,32,18,0,0,18,10,24,5
94,Rúben Dias,POR,DF,Manchester City,24-167,1997,8.2,12,8,7,2,3,3,6,50.0,3,40,18,45.0,23,14,3,13,8,0,5,10,22,36
95,Eric Dier,ENG,DF,Tottenham,27-286,1994,8.1,2,1,1,0,1,0,3,0.0,3,34,11,32.4,21,12,1,17,12,1,5,15,17,55
96,Lucas Digne,FRA,DF,Everton,28-100,1993,9.0,23,15,16,2,5,13,19,68.4,6,111,34,30.6,51,34,26,21,4,0,17,17,40,26
97,Virgil van Dijk,NED,DF,Liverpool,30-112,1991,9.0,6,4,3,3,0,2,3,66.7,1,23,8,34.8,13,8,2,9,7,0,2,9,15,49
98,Moussa Djenepo,MLI,MF,Southampton,23-135,1998,4.5,13,8,6,6,1,6,11,54.5,5,93,22,23.7,43,35,15,7,1,0,6,9,22,3
99,Lewis Dobbin,ENG,"MF,FW",Everton,18-298,2003,0.0,1,1,0,1,0,0,1,0.0,1,3,2,66.7,0,1,2,0,0,0,0,0,1,0
100,Matt Doherty,IRL,DF,Tottenham,29-285,1992,0.1,1,1,0,1,0,0,0,,0,2,0,0.0,1,1,0,1,0,0,1,0,1,0
101,Gabriel Dos Santos,BRA,DF,Arsenal,23-313,1997,6.0,8,7,6,1,1,3,4,75.0,1,40,18,45.0,22,15,3,11,9,0,2,4,12,25
102,Abdoulaye Doucouré,FRA,MF,Everton,28-300,1993,8.0,20,9,10,9,1,12,23,52.2,11,195,51,26.2,88,76,31,12,1,0,11,13,33,16
103,Kieran Dowell,ENG,FW,Norwich City,24-018,1997,0.7,3,2,1,0,2,2,3,66.7,1,16,3,18.8,7,4,5,1,0,0,1,0,3,0
104,Shane Duffy,IRL,DF,Brighton,29-300,1992,8.0,8,6,6,1,1,3,8,37.5,5,52,12,23.1,33,16,3,17,9,1,8,9,17,52
105,Lewis Dunk,ENG,DF,Brighton,29-341,1991,9.0,10,6,7,2,1,1,4,25.0,3,53,21,39.6,30,19,4,15,11,0,4,14,24,32
106,Ederson,BRA,GK,Manchester City,28-072,1993,8.0,0,0,0,0,0,0,0,,0,1,0,0.0,1,0,0,0,0,0,0,0,0,0
107,Odsonne Édouard,FRA,FW,Crystal Palace,23-285,1998,4.0,6,4,1,2,3,0,6,0.0,6,96,27,28.1,9,32,55,7,1,0,6,5,11,4
108,Harvey Elliott,ENG,MF,Liverpool,18-207,2003,2.8,1,1,1,0,0,0,5,0.0,5,68,16,23.5,17,33,18,7,0,0,7,2,3,3
109,Mohamed Elneny,EGY,"MF,FW",Arsenal,29-109,1992,0.5,1,0,1,0,0,1,1,100.0,0,8,2,25.0,7,1,0,0,0,0,0,0,1,0
110,Mohamed Elyounoussi,NOR,MF,Southampton,27-085,1994,6.0,12,8,2,7,3,1,1,100.0,0,117,34,29.1,30,53,34,8,0,0,8,5,17,6
111,Emerson,BRA,DF,Tottenham,22-287,1999,5.5,26,11,19,6,1,9,16,56.3,7,138,40,29.0,71,49,18,9,1,0,8,15,41,18
112,Oghenekaro Etebo,NGA,MF,Watford,25-353,1995,4.1,12,10,5,7,0,4,7,57.1,3,62,22,35.5,28,31,3,5,1,0,4,7,19,6
113,Jonny Evans,NIR,DF,Leicester City,33-298,1988,2.3,1,0,0,1,0,1,1,100.0,0,17,4,23.5,12,4,1,4,4,0,0,10,11,14
114,Łukasz Fabiański,POL,GK,West Ham,36-193,1985,9.0,0,0,0,0,0,0,0,,0,0,0,,0,0,0,0,0,0,0,0,0,0
115,Fabinho,BRA,MF,Liverpool,28-005,1993,5.3,8,4,3,4,1,2,9,22.2,7,91,23,25.3,29,45,17,11,2,0,9,8,16,8
116,Kiko Femenía,ESP,DF,Watford,30-268,1991,3.0,3,0,2,1,0,3,5,60.0,2,27,6,22.2,16,8,3,7,3,0,4,3,6,8
117,Bruno Fernandes,POR,MF,Manchester Utd,27-050,1994,8.6,11,9,3,4,4,4,17,23.5,13,149,40,26.8,17,81,51,5,0,0,5,6,17,7
118,Federico Fernández,ARG,DF,Newcastle Utd,32-249,1989,4.9,1,1,0,1,0,0,6,0.0,6,24,4,16.7,13,9,2,9,7,0,2,8,9,19
119,Fernandinho,BRA,MF,Manchester City,36-177,1985,2.1,8,5,1,6,1,1,7,14.3,6,31,10,32.3,9,19,3,3,0,0,3,0,8,5
120,Roberto Firmino,BRA,FW,Liverpool,30-026,1991,3.3,5,4,1,3,1,0,3,0.0,3,71,23,32.4,10,30,31,5,0,0,5,1,6,1
121,Junior Firpo,ESP,DF,Leeds United,25-067,1996,5.2,18,10,12,5,1,7,11,63.6,4,89,25,28.1,44,31,14,9,1,0,8,11,29,11
122,Phil Foden,ENG,FW,Manchester City,21-153,2000,4.2,2,2,1,0,1,1,1,100.0,0,89,23,25.8,11,34,44,5,1,0,4,3,5,0
123,Pablo Fornals,ESP,"FW,MF",West Ham,25-248,1996,8.8,17,9,6,6,5,8,26,30.8,18,194,52,26.8,60,85,49,17,1,0,16,14,31,6
124,Adam Forshaw,ENG,MF,Leeds United,30-020,1991,0.3,1,0,0,1,0,1,1,100.0,0,7,1,14.3,0,6,1,0,0,0,0,0,1,0
125,Marcus Forss,FIN,"FW,MF",Brentford,22-132,1999,0.7,0,0,0,0,0,0,1,0.0,1,15,4,26.7,3,2,10,1,0,0,1,0,0,0
126,Ben Foster,ENG,GK,Watford,38-208,1983,5.0,0,0,0,0,0,0,2,0.0,2,1,0,0.0,1,0,0,0,0,0,0,0,0,3
127,Ryan Fraser,SCO,MF,Newcastle Utd,27-246,1994,1.5,1,0,1,0,0,0,2,0.0,2,13,2,15.4,3,7,3,0,0,0,0,3,4,1
128,Fred,BRA,MF,Manchester Utd,28-237,1993,6.6,19,15,6,10,3,5,20,25.0,15,151,39,25.8,41,94,16,11,2,0,9,10,29,13
129,Ryan Fredericks,ENG,DF,West Ham,29-018,1992,0.0,0,0,0,0,0,0,0,,0,0,0,,0,0,0,1,0,0,1,0,0,0
130,Conor Gallagher,ENG,MF,Crystal Palace,21-264,2000,7.7,19,13,11,3,5,4,16,25.0,12,192,54,28.1,48,97,47,13,2,0,11,6,25,10
131,Dwight Gayle,ENG,FW,Newcastle Utd,31-011,1990,0.2,0,0,0,0,0,0,0,,0,8,1,12.5,1,6,1,0,0,0,0,0,0,0
132,David de Gea,ESP,GK,Manchester Utd,30-355,1990,9.0,0,0,0,0,0,0,0,,0,0,0,,0,0,0,0,0,0,0,0,0,0
133,Joe Gelhardt,ENG,"FW,MF",Leeds United,19-177,2002,0.5,0,0,0,0,0,0,0,,0,11,4,36.4,2,4,5,0,0,0,0,1,1,0
134,Anwar El Ghazi,NED,"FW,MF",Aston Villa,26-178,1995,2.8,2,2,0,2,0,1,4,25.0,3,27,10,37.0,4,13,10,2,0,0,2,0,2,1
135,Saman Ghoddos,IRN,"MF,DF",Brentford,28-052,1993,1.3,4,4,2,2,0,2,3,66.7,1,25,10,40.0,5,15,5,1,0,0,1,2,6,2
136,Dimitris Giannoulis,GRE,DF,Norwich City,26-011,1995,4.1,11,5,6,5,0,7,9,77.8,2,60,15,25.0,33,16,11,15,2,0,13,11,22,8
137,Morgan Gibbs-White,ENG,"FW,MF",Wolves,21-274,2000,0.1,0,0,0,0,0,0,0,,0,3,0,0.0,1,1,1,1,0,0,1,0,0,0
138,Ben Gibson,ENG,DF,Norwich City,28-286,1993,6.7,5,3,5,0,0,2,3,66.7,1,30,9,30.0,20,9,1,16,7,0,9,15,20,49
139,Billy Gilmour,SCO,MF,Norwich City,20-139,2001,3.9,11,8,7,4,0,4,9,44.4,5,81,22,27.2,46,29,6,3,0,0,3,7,18,12
140,Ben Godfrey,ENG,DF,Everton,23-286,1998,5.5,13,5,6,6,1,3,6,50.0,3,66,19,28.8,42,20,4,16,6,0,10,19,32,26
141,André Gomes,POR,MF,Everton,28-090,1993,0.8,1,0,0,0,1,0,0,,0,20,7,35.0,4,9,7,2,0,0,2,2,3,0
142,Joe Gomez,ENG,DF,Liverpool,24-158,1997,0.2,0,0,0,0,0,0,0,,0,0,0,,0,0,0,0,0,0,0,1,1,0
143,Anthony Gordon,ENG,MF,Everton,20-246,2001,2.0,7,4,3,3,1,4,8,50.0,4,41,10,24.4,16,17,8,4,0,0,4,7,14,1
144,Dan Gosling,ENG,MF,Watford,31-269,1990,0.2,0,0,0,0,0,0,4,0.0,4,5,1,20.0,2,3,0,0,0,0,0,0,0,1
145,Demarai Gray,ENG,MF,Everton,25-122,1996,8.4,10,6,3,5,2,6,11,54.5,5,92,30,32.6,19,39,34,5,0,0,5,7,17,6
146,Jack Grealish,ENG,"FW,MF",Manchester City,26-048,1995,7.3,9,6,3,5,1,2,5,40.0,3,95,32,33.7,13,39,43,5,1,0,4,4,13,0
147,Mason Greenwood,ENG,FW,Manchester Utd,20-027,2001,8.1,6,2,2,0,4,2,5,40.0,3,75,21,28.0,12,28,35,4,0,0,4,4,10,2
148,Pascal Groß,GER,"MF,DF",Brighton,30-135,1991,6.7,11,7,9,2,0,5,9,55.6,4,103,28,27.2,43,36,24,9,0,0,9,3,14,11
149,Vicente Guaita,ESP,GK,Crystal Palace,34-291,1987,9.0,0,0,0,0,0,0,0,,0,1,0,0.0,1,0,0,0,0,0,0,0,0,0
150,Marc Guéhi,ENG,DF,Crystal Palace,21-107,2000,9.0,9,6,6,3,0,4,5,80.0,1,56,22,39.3,35,18,3,11,5,0,6,9,18,40
151,İlkay Gündoğan,GER,MF,Manchester City,31-004,1990,5.6,7,3,1,6,0,2,8,25.0,6,55,12,21.8,17,25,13,5,2,1,3,4,11,4
152,Grant Hanley,SCO,DF,Norwich City,29-342,1991,9.0,16,13,8,7,1,7,9,77.8,2,93,37,39.8,66,24,3,16,11,0,5,18,34,65
153,Jack Harrison,ENG,"MF,FW",Leeds United,24-342,1996,5.5,6,4,2,3,1,5,11,45.5,6,89,24,27.0,23,37,29,5,0,0,5,6,12,5
154,Kortney Hause,ENG,DF,Aston Villa,26-104,1995,1.9,1,1,0,0,1,1,1,100.0,0,22,8,36.4,11,10,1,6,4,0,2,7,8,9
155,Kai Havertz,GER,"FW,MF",Chelsea,22-139,1999,4.3,5,2,2,2,1,2,7,28.6,5,70,19,27.1,7,26,37,9,0,0,9,3,8,12
156,Isaac Hayden,ENG,"MF,DF",Newcastle Utd,26-220,1995,7.5,20,10,9,9,2,6,17,35.3,11,135,41,30.4,53,70,12,16,6,0,10,12,32,23
157,Hwang Hee-chan,KOR,"FW,MF",Wolves,25-275,1996,4.7,4,3,1,3,0,2,12,16.7,10,76,19,25.0,19,32,25,4,0,0,4,6,10,5
158,Jordan Henderson,ENG,MF,Liverpool,31-133,1990,7.1,10,7,1,7,2,5,13,38.5,8,130,42,32.3,32,75,23,8,0,0,8,12,22,3
159,Jeff Hendrick,IRL,MF,Newcastle Utd,29-270,1992,0.7,1,1,0,1,0,1,1,100.0,0,16,2,12.5,2,11,3,0,0,0,0,0,1,1
160,Rico Henry,ENG,DF,Brentford,24-112,1997,8.8,11,10,5,4,2,3,8,37.5,5,116,41,35.3,44,47,25,22,4,0,18,16,27,15
161,Son Heung-min,KOR,FW,Tottenham,29-112,1992,7.8,3,3,1,1,1,0,4,0.0,4,81,19,23.5,7,44,30,7,0,0,7,1,4,1
162,Ki-Jana Hoever,NED,DF,Wolves,19-283,2002,1.1,8,6,5,3,0,3,7,42.9,4,31,9,29.0,17,12,2,0,0,0,0,1,9,3
163,Rob Holding,ENG,"DF,MF",Arsenal,26-038,1995,2.0,5,3,5,0,0,2,2,100.0,0,15,4,26.7,13,1,1,11,9,0,2,5,10,12
164,Mason Holgate,ENG,DF,Everton,25-006,1996,2.0,3,0,3,0,0,0,1,0.0,1,14,1,7.1,9,3,2,4,2,0,2,6,9,19
165,Callum Hudson-Odoi,ENG,"MF,FW",Chelsea,20-355,2000,2.4,4,2,2,2,0,1,5,20.0,4,40,11,27.5,8,13,19,3,0,0,3,1,5,2
166,Pierre Højbjerg,DEN,MF,Tottenham,26-084,1995,9.0,27,19,5,20,2,12,30,40.0,18,196,54,27.6,68,101,27,19,3,0,16,20,47,19
167,Adam Idah,IRL,FW,Norwich City,20-231,2001,0.5,1,1,0,0,1,0,1,0.0,1,10,3,30.0,1,5,4,1,1,0,0,0,1,1
168,Kelechi Iheanacho,NGA,"FW,MF",Leicester City,25-025,1996,3.9,6,3,1,4,1,2,4,50.0,2,93,23,24.7,5,52,36,4,0,0,4,2,8,2
169,Danny Ings,ENG,FW,Aston Villa,29-097,1992,8.4,7,2,2,4,1,3,8,37.5,5,150,22,14.7,22,56,72,12,3,0,9,9,16,6
170,Alex Iwobi,NGA,"MF,FW",Everton,25-178,1996,4.2,3,2,2,0,1,2,5,40.0,3,67,23,34.3,21,30,16,6,0,0,6,6,9,6
171,Daniel James,WAL,FW,Manchester Utd,23-352,1997,1.4,4,4,0,4,0,1,1,100.0,0,31,8,25.8,5,13,13,2,0,0,2,0,4,1
172,Daniel James,WAL,"MF,FW",Leeds United,23-352,1997,4.4,5,2,2,0,3,2,5,40.0,3,48,7,14.6,13,15,20,5,0,0,5,7,12,5
173,Reece James,ENG,"DF,MF",Chelsea,21-324,1999,3.1,9,6,7,1,1,3,6,50.0,3,58,19,32.8,32,18,8,7,1,1,6,4,13,3
174,Vitaly Janelt,GER,MF,Brentford,23-171,1998,5.7,20,14,5,11,4,6,13,46.2,7,95,30,31.6,21,49,25,11,1,0,10,10,30,6
175,Pontus Jansson,SWE,DF,Brentford,30-257,1991,8.9,8,6,7,1,0,4,8,50.0,4,49,22,44.9,33,14,2,11,5,0,6,20,28,44
176,Mathias Jensen,DEN,MF,Brentford,25-300,1996,3.1,7,6,3,2,2,5,16,31.3,11,79,19,24.1,29,30,20,9,1,0,8,3,10,3
177,Gabriel Jesus,BRA,FW,Manchester City,24-208,1997,6.5,8,5,3,2,3,2,9,22.2,7,101,20,19.8,12,45,44,13,1,0,12,4,12,1
178,Raúl Jiménez,MEX,FW,Wolves,30-176,1991,8.0,7,5,0,3,4,1,7,14.3,6,114,28,24.6,9,45,60,6,0,0,6,4,11,7
179,Joelinton,BRA,"MF,FW",Newcastle Utd,25-075,1996,5.6,6,5,3,1,2,1,4,25.0,3,99,35,35.4,25,47,27,12,1,0,11,7,13,7
180,Ben Johnson,ENG,DF,West Ham,21-277,2000,2.0,7,4,5,0,2,4,6,66.7,2,19,10,52.6,9,3,7,2,0,0,2,6,13,4
181,Curtis Jones,ENG,MF,Liverpool,20-271,2001,2.6,3,2,0,3,0,0,0,,0,63,12,19.0,11,42,10,0,0,0,0,0,3,0
182,Jorginho,ITA,MF,Chelsea,29-312,1991,6.2,21,13,12,7,2,7,24,29.2,17,144,46,31.9,52,70,22,8,4,0,4,15,36,7
183,Diogo Jota,POR,FW,Liverpool,24-328,1996,6.6,7,4,3,3,1,3,12,25.0,9,147,34,23.1,29,59,59,6,2,0,4,3,10,3
184,Mathias Jørgensen,DEN,DF,Brentford,31-188,1990,3.6,9,2,3,4,2,5,7,71.4,2,34,8,23.5,19,10,5,6,1,0,5,7,16,7
185,Ozan Kabak,TUR,DF,Norwich City,21-217,2000,4.8,3,2,1,1,1,0,3,0.0,3,43,13,30.2,27,15,1,8,5,0,3,7,10,24
186,Christian Kabasele,BEL,DF,Watford,30-246,1991,2.3,0,0,0,0,0,0,1,0.0,1,10,4,40.0,8,2,0,8,3,0,5,7,7,10
187,Harry Kane,ENG,"FW,MF",Tottenham,28-092,1993,7.2,4,3,0,2,2,0,3,0.0,3,89,23,25.8,1,34,54,3,2,0,1,0,4,9
188,N'Golo Kanté,FRA,MF,Chelsea,30-213,1991,2.9,7,5,4,2,1,1,5,20.0,4,40,15,37.5,15,14,11,6,1,0,5,4,11,2
189,Moise Kean,ITA,FW,Everton,21-242,2000,0.0,0,0,0,0,0,0,0,,0,0,0,,0,0,0,0,0,0,0,0,0,0
190,Michael Keane,ENG,DF,Everton,28-290,1993,9.0,12,9,10,2,0,4,10,40.0,6,47,17,36.2,32,14,1,19,13,0,6,15,27,56
191,Naby Keïta,GUI,MF,Liverpool,26-260,1995,3.8,14,11,6,5,3,7,10,70.0,3,93,27,29.0,23,46,24,9,1,0,8,2,16,0
192,Caoimhín Kelleher,IRL,GK,Liverpool,22-339,1998,1.0,0,0,0,0,0,0,0,,0,0,0,,0,0,0,0,0,0,0,0,0,0
193,Jonjoe Kenny,ENG,DF,Everton,24-227,1997,0.1,1,1,1,0,0,0,0,,0,1,1,100.0,1,0,0,0,0,0,0,0,1,0
194,Max Kilman,ENG,DF,Wolves,24-158,1997,9.0,20,11,14,6,0,9,13,69.2,4,83,28,33.7,49,30,4,12,4,0,8,16,36,45
195,Joshua King,NOR,FW,Watford,29-286,1992,5.1,5,5,1,3,1,0,2,0.0,2,80,23,28.8,9,41,30,3,1,0,2,3,8,6
196,Mateusz Klich,POL,MF,Leeds United,31-137,1990,6.2,9,6,2,3,4,5,14,35.7,9,123,32,26.0,29,58,36,1,0,0,1,2,11,3
197,Robin Koch,GER,MF,Leeds United,25-103,1996,1.0,3,2,1,2,0,0,2,0.0,2,21,7,33.3,8,12,1,2,0,0,2,5,8,3
198,Sead Kolašinac,BIH,DF,Arsenal,28-130,1993,1.0,1,1,1,0,0,0,0,,0,12,3,25.0,7,3,2,2,0,0,2,4,5,8
199,Ibrahima Konaté,FRA,DF,Liverpool,22-156,1999,2.0,3,2,3,0,0,2,2,100.0,0,12,6,50.0,9,3,0,2,2,0,0,3,6,7
200,Ezri Konsa,ENG,DF,Aston Villa,24-005,1997,9.0,9,6,4,4,1,1,4,25.0,3,65,25,38.5,29,30,6,19,11,0,8,20,29,27
201,Cheikhou Kouyaté,SEN,"MF,DF",Crystal Palace,31-311,1989,5.1,9,6,4,5,0,2,7,28.6,5,73,21,28.8,43,27,3,16,5,0,11,12,21,16
202,Mateo Kovačić,CRO,MF,Chelsea,27-175,1994,7.8,28,21,9,15,4,9,17,52.9,8,180,58,32.2,42,99,39,9,2,0,7,10,38,8
203,Emil Krafth,SWE,DF,Newcastle Utd,27-087,1994,2.0,3,0,3,0,0,3,9,33.3,6,34,10,29.4,20,14,0,4,2,0,2,4,7,11
204,Tim Krul,NED,GK,Norwich City,33-208,1988,9.0,0,0,0,0,0,0,1,0.0,1,4,0,0.0,4,0,0,0,0,0,0,0,0,0
205,Juraj Kucka,SVK,MF,Watford,34-244,1987,7.5,26,16,14,10,2,12,25,48.0,13,142,47,33.1,54,70,18,11,6,1,5,14,40,17
206,Alexandre Lacazette,FRA,"MF,FW",Arsenal,30-153,1991,1.6,0,0,0,0,0,0,1,0.0,1,33,9,27.3,8,16,9,2,0,0,2,3,3,0
207,Adam Lallana,ENG,MF,Brighton,33-171,1988,8.0,19,11,7,9,3,6,21,28.6,15,156,48,30.8,65,66,25,13,3,0,10,15,34,10
208,Tariq Lamptey,ENG,DF,Brighton,21-028,2000,0.7,2,1,1,1,0,0,0,,0,7,1,14.3,1,4,2,2,0,0,2,2,4,0
209,Manuel Lanzini,ARG,"FW,MF",West Ham,28-255,1993,0.3,3,1,2,1,0,1,4,25.0,3,13,4,30.8,4,8,1,1,0,0,1,1,4,0
210,Aymeric Laporte,ESP,DF,Manchester City,27-154,1994,6.8,2,0,2,0,0,1,2,50.0,1,30,11,36.7,19,10,1,3,2,0,1,9,11,24
211,Jamaal Lascelles,ENG,DF,Newcastle Utd,27-351,1993,6.0,3,2,2,1,0,1,4,25.0,3,32,10,31.3,19,12,1,16,9,0,7,8,11,33
212,Pierre Lees-Melou,FRA,MF,Norwich City,28-156,1993,7.2,20,12,10,9,1,6,21,28.6,15,210,46,21.9,80,106,24,22,4,1,18,11,31,4
213,Aaron Lennon,ENG,MF,Burnley,34-195,1987,1.2,3,2,1,2,0,1,6,16.7,5,26,12,46.2,7,14,5,4,1,0,3,1,4,1
214,Bernd Leno,GER,GK,Arsenal,29-238,1992,3.0,0,0,0,0,0,0,0,,0,0,0,,0,0,0,0,0,0,0,0,0,0
215,Jamal Lewis,NIR,DF,Newcastle Utd,23-276,1998,0.1,0,0,0,0,0,0,0,,0,2,0,0.0,1,0,1,0,0,0,0,0,0,0
216,Victor Lindelöf,SWE,DF,Manchester Utd,27-103,1994,5.3,2,1,1,1,0,2,2,100.0,0,20,9,45.0,9,8,3,8,2,0,6,9,11,36
217,Jesse Lingard,ENG,FW,Manchester Utd,28-317,1992,0.7,2,1,0,2,0,1,1,100.0,0,14,4,28.6,3,5,6,0,0,0,0,2,4,0
218,Valentino Livramento,ENG,DF,Southampton,18-350,2002,8.9,17,9,10,4,3,11,19,57.9,8,123,31,25.2,58,45,20,8,3,0,5,25,42,14
219,Diego Llorente,ESP,DF,Leeds United,28-073,1993,4.1,8,5,4,3,1,2,4,50.0,2,71,28,39.4,41,29,1,12,3,0,9,6,14,23
220,Hugo Lloris,FRA,GK,Tottenham,34-306,1986,9.0,0,0,0,0,0,0,0,,0,0,0,,0,0,0,0,0,0,0,0,0,0
221,Giovani Lo Celso,ARG,"MF,FW",Tottenham,25-202,1996,1.3,4,1,3,1,0,2,8,25.0,6,42,7,16.7,13,19,10,3,0,0,3,1,5,0
222,Ruben Loftus-Cheek,ENG,MF,Chelsea,25-278,1996,2.4,8,4,4,3,1,2,6,33.3,4,46,18,39.1,13,27,6,5,1,0,4,4,12,7
223,Shane Long,IRL,MF,Southampton,34-279,1987,0.2,1,1,0,1,0,0,0,,0,3,3,100.0,0,2,1,0,0,0,0,0,1,1
224,Sean Longstaff,ENG,MF,Newcastle Utd,23-363,1997,7.0,30,21,13,13,4,11,30,36.7,19,197,56,28.4,85,90,22,13,4,0,9,14,44,13
225,Ademola Lookman,ENG,"FW,MF",Leicester City,24-008,1997,2.4,7,7,1,5,1,3,3,100.0,0,48,19,39.6,10,24,14,5,0,0,5,3,10,1
226,Imran Louza,MAR,MF,Watford,22-180,1999,0.5,1,0,0,1,0,0,1,0.0,1,7,3,42.9,1,5,1,0,0,0,0,0,1,0
227,Matthew Lowton,ENG,DF,Burnley,32-141,1989,9.0,23,13,10,8,5,10,19,52.6,9,81,36,44.4,33,30,18,24,8,0,16,12,35,25
228,Douglas Luiz,BRA,MF,Aston Villa,23-172,1998,7.6,14,9,7,5,2,7,18,38.9,11,122,35,28.7,50,62,10,17,4,0,13,19,33,7
229,Romelu Lukaku,BEL,FW,Chelsea,28-168,1993,6.8,2,1,0,1,1,0,0,,0,43,18,41.9,2,20,21,5,3,0,2,1,3,8
230,Alexis Mac Allister,ARG,"FW,MF",Brighton,22-308,1998,2.4,12,8,4,6,2,4,9,44.4,5,74,30,40.5,22,29,23,7,1,0,6,2,14,1
231,James Maddison,ENG,"MF,FW",Leicester City,24-339,1996,5.8,9,5,1,5,3,3,7,42.9,4,108,28,25.9,30,54,24,5,0,0,5,5,14,1
232,Harry Maguire,ENG,DF,Manchester Utd,28-237,1993,7.7,8,3,5,3,0,4,9,44.4,5,35,13,37.1,23,11,1,12,11,0,1,12,20,52
233,Riyad Mahrez,ALG,FW,Manchester City,30-249,1991,2.8,2,1,0,1,1,1,3,33.3,2,32,15,46.9,3,13,16,0,0,0,0,1,3,0
234,Ainsley Maitland-Niles,ENG,"MF,DF",Arsenal,24-060,1997,1.6,2,1,0,1,1,0,2,0.0,2,27,7,25.9,10,11,6,3,1,0,2,2,4,1
235,Sadio Mané,SEN,FW,Liverpool,29-201,1992,8.2,9,4,0,6,3,0,3,0.0,3,90,29,32.2,15,38,37,8,0,0,8,4,13,4
236,Javier Manquillo,ESP,DF,Newcastle Utd,27-176,1994,5.5,18,11,11,5,2,7,15,46.7,8,71,22,31.0,38,22,11,15,5,0,10,4,22,12
237,Fernando Marçal,BRA,DF,Wolves,32-251,1989,7.6,19,14,12,5,2,7,17,41.2,10,115,33,28.7,59,42,14,18,2,0,16,18,37,27
238,Solly March,ENG,"DF,MF",Brighton,27-100,1994,4.1,9,3,5,1,3,2,7,28.6,5,62,22,35.5,25,15,22,8,0,0,8,7,16,7
239,Pablo Marí,ESP,DF,Arsenal,28-058,1993,2.0,6,2,2,3,1,4,8,50.0,4,19,4,21.1,9,8,2,6,4,0,2,6,12,11
240,Anthony Martial,FRA,FW,Manchester Utd,25-327,1995,1.7,1,1,0,0,1,0,1,0.0,1,24,8,33.3,4,9,11,2,0,0,2,1,2,2
241,Martinelli,BRA,FW,Arsenal,20-132,2001,1.8,3,2,0,1,2,1,3,33.3,2,42,9,21.4,7,15,20,4,1,0,3,0,3,2
242,Emiliano Martínez,ARG,GK,Aston Villa,29-056,1992,8.0,0,0,0,0,0,0,0,,0,1,0,0.0,1,0,0,0,0,0,0,0,0,1
243,Adam Masina,MAR,DF,Watford,27-299,1994,4.5,8,4,5,3,0,3,8,37.5,5,60,17,28.3,29,22,9,8,1,0,7,9,17,19
244,Jean-Philippe Mateta,FRA,FW,Crystal Palace,24-122,1997,0.7,1,0,1,0,0,1,1,100.0,0,16,3,18.8,1,10,5,1,1,0,0,0,1,1
245,Nemanja Matić,SRB,MF,Manchester Utd,33-088,1988,3.1,9,7,4,4,1,3,5,60.0,2,45,16,35.6,15,28,2,8,2,0,6,6,15,7
246,Joël Matip,CMR,DF,Liverpool,30-081,1991,7.0,6,5,1,5,0,2,4,50.0,2,48,18,37.5,23,20,5,10,6,1,4,11,17,31
247,Neal Maupay,FRA,FW,Brighton,25-075,1996,8.1,8,5,1,4,3,2,5,40.0,3,161,41,25.5,17,60,84,6,0,0,6,5,13,1
248,Bryan Mbeumo,FRA,FW,Brentford,22-082,1999,8.2,6,4,0,3,3,1,3,33.3,2,131,29,22.1,13,57,61,14,2,0,12,1,7,5
249,James McArthur,SCO,MF,Crystal Palace,34-021,1987,8.7,17,11,10,7,0,7,22,31.8,15,198,62,31.3,57,110,31,18,5,0,13,16,33,21
250,Alex McCarthy,ENG,GK,Southampton,31-329,1989,9.0,0,0,0,0,0,0,0,,0,0,0,,0,0,0,0,0,0,0,0,0,0
251,John McGinn,SCO,MF,Aston Villa,27-010,1994,7.4,17,10,3,9,5,4,14,28.6,10,118,35,29.7,23,69,26,4,1,0,3,12,29,6
252,Kenny McLean,SCO,MF,Norwich City,29-293,1992,7.5,9,5,7,2,0,4,15,26.7,11,112,22,19.6,59,43,10,8,2,0,6,14,23,13
253,Dwight McNeil,ENG,MF,Burnley,21-340,1999,8.8,17,11,6,9,2,3,24,12.5,21,183,51,27.9,67,73,43,29,7,2,22,16,33,3
254,Scott McTominay,SCO,MF,Manchester Utd,24-324,1996,4.9,9,4,6,2,1,3,9,33.3,6,64,14,21.9,21,36,7,7,2,0,5,6,15,15
255,Ben Mee,ENG,DF,Burnley,32-035,1989,6.0,4,2,2,1,1,1,4,25.0,3,32,9,28.1,17,13,2,11,6,0,5,9,13,38
256,Benjamin Mendy,FRA,DF,Manchester City,27-103,1994,0.9,3,1,1,1,1,2,4,50.0,2,12,2,16.7,3,8,1,0,0,0,0,0,3,3
257,Edouard Mendy,SEN,GK,Chelsea,29-241,1992,8.0,0,0,0,0,0,0,1,0.0,1,1,1,100.0,1,0,0,0,0,0,0,0,0,0
258,Illan Meslier,FRA,GK,Leeds United,21-240,2000,9.0,0,0,0,0,0,0,0,,0,1,0,0.0,1,0,0,0,0,0,0,0,0,0
259,Luka Milivojević,SRB,MF,Crystal Palace,30-204,1991,3.6,5,3,2,2,1,4,8,50.0,4,55,16,29.1,16,31,8,2,0,0,2,3,8,6
260,James Milner,ENG,"DF,MF",Liverpool,35-297,1986,4.1,13,7,7,4,2,6,17,35.3,11,59,22,37.3,13,35,11,7,2,0,5,10,23,12
261,Yerry Mina,COL,DF,Everton,27-035,1994,5.1,10,6,10,0,0,4,7,57.1,3,42,16,38.1,30,11,1,10,6,0,4,6,16,34
262,Tyrone Mings,ENG,DF,Aston Villa,28-229,1993,8.0,7,3,1,5,1,2,5,40.0,3,58,10,17.2,28,24,6,22,12,1,10,21,28,42
263,Tyrick Mitchell,ENG,DF,Crystal Palace,22-057,1999,9.0,30,17,17,12,1,11,20,55.0,9,173,57,32.9,89,59,25,16,1,0,15,16,46,16
264,Jakub Moder,POL,"MF,DF",Brighton,22-204,1999,4.9,8,6,2,5,1,4,10,40.0,6,81,24,29.6,30,28,23,5,0,0,5,2,10,8
265,Wesley Moraes,BRA,FW,Aston Villa,24-336,1996,0.0,0,0,0,0,0,0,0,,0,2,1,50.0,1,0,1,0,0,0,0,0,0,0
266,Mason Mount,ENG,"MF,FW",Chelsea,22-291,1999,5.0,6,4,2,1,3,1,10,10.0,9,95,26,27.4,20,38,37,3,0,0,3,3,9,4
267,Lucas Moura,BRA,FW,Tottenham,29-076,1992,7.0,10,5,2,4,4,0,13,0.0,13,98,23,23.5,26,45,27,4,0,0,4,7,17,11
268,João Moutinho,POR,MF,Wolves,35-050,1986,8.3,15,11,6,6,3,9,22,40.9,13,142,48,33.8,60,67,15,12,2,0,10,16,31,10
269,Bali Mumba,ENG,DF,Norwich City,20-020,2001,0.5,1,0,1,0,0,0,0,,0,12,3,25.0,10,2,0,2,0,0,2,1,2,5
270,Jacob Murphy,ENG,"DF,MF",Newcastle Utd,26-246,1995,3.7,11,5,6,5,0,5,11,45.5,6,72,20,27.8,36,25,11,7,0,0,7,7,18,3
271,Enock Mwepu,ZAM,MF,Brighton,23-300,1998,1.4,5,1,3,2,0,0,4,0.0,4,37,11,29.7,13,15,9,4,0,0,4,2,7,2
272,Marvelous Nakamba,ZIM,MF,Aston Villa,27-282,1994,2.3,2,2,1,1,0,2,7,28.6,5,35,9,25.7,11,18,6,1,0,0,1,2,4,2
273,Wilfred Ndidi,NGA,MF,Leicester City,24-316,1996,6.0,26,19,15,10,1,8,23,34.8,15,139,42,30.2,59,67,13,8,1,0,7,13,39,18
274,Tanguy Ndombele,FRA,MF,Tottenham,24-304,1996,4.2,11,8,4,6,1,0,0,,0,62,20,32.3,13,35,14,1,0,0,1,1,12,1
275,Reiss Nelson,ENG,FW,Arsenal,21-322,1999,0.2,1,0,0,1,0,0,0,,0,8,2,25.0,2,5,1,0,0,0,0,1,2,0
276,Rúben Neves,POR,MF,Wolves,24-229,1997,7.1,18,10,4,11,3,8,23,34.8,15,130,40,30.8,36,76,18,8,1,0,7,8,26,17
277,Jeremy Ngakia,ENG,DF,Watford,21-051,2000,3.3,13,7,10,1,2,9,17,52.9,8,74,27,36.5,48,15,11,3,0,0,3,15,28,3
278,Saúl Ñíguez,ESP,MF,Chelsea,26-341,1994,0.5,0,0,0,0,0,0,1,0.0,1,15,1,6.7,7,8,0,2,1,0,1,0,0,1
279,Nicolas Nkoulou,CMR,DF,Watford,31-215,1990,0.2,0,0,0,0,0,0,0,,0,0,0,,0,0,0,1,0,0,1,0,0,0
280,Mark Noble,ENG,FW,West Ham,34-173,1987,0.0,0,0,0,0,0,0,0,,0,0,0,,0,0,0,0,0,0,0,0,0,0
281,Mathias Normann,NOR,MF,Norwich City,25-153,1996,4.4,7,5,5,1,1,2,5,40.0,3,66,8,12.1,29,33,4,9,5,0,4,3,10,12
282,Christian Nørgaard,DEN,MF,Brentford,27-232,1994,8.9,29,23,10,18,1,12,22,54.5,10,168,60,35.7,57,99,12,10,1,0,9,25,54,9
283,Angelo Ogbonna,ITA,DF,West Ham,33-158,1988,9.0,13,8,8,5,0,3,7,42.9,4,46,15,32.6,30,13,3,7,4,0,3,11,24,33
284,Michael Olise,FRA,"FW,MF",Crystal Palace,19-320,2001,1.5,2,2,0,2,0,1,1,100.0,0,26,15,57.7,4,16,6,1,0,0,1,1,3,2
285,Andrew Omobamidele,IRL,DF,Norwich City,19-127,2002,1.2,1,1,1,0,0,0,0,,0,15,3,20.0,12,3,0,3,3,0,0,3,4,7
286,Frank Onyeka,NGA,MF,Brentford,23-300,1998,5.3,16,9,7,7,2,1,5,20.0,4,114,37,32.5,44,51,19,9,1,0,8,4,20,6
287,Divock Origi,BEL,FW,Liverpool,26-193,1995,0.0,0,0,0,0,0,0,0,,0,2,0,0.0,1,1,0,0,0,0,0,1,1,0
288,Alex Oxlade-Chamberlain,ENG,"MF,FW",Liverpool,28-074,1993,1.4,3,2,1,2,0,0,2,0.0,2,32,5,15.6,6,19,7,1,0,0,1,6,9,0
289,Cole Palmer,ENG,MF,Manchester City,19-175,2002,0.3,1,1,0,1,0,0,1,0.0,1,9,1,11.1,0,5,4,0,0,0,0,1,2,0
290,Emerson Palmieri,ITA,DF,Chelsea,27-086,1994,0.1,0,0,0,0,0,0,0,,0,0,0,,0,0,0,0,0,0,0,0,0,0
291,Thomas Partey,GHA,MF,Arsenal,28-137,1993,5.0,14,10,6,7,1,4,13,30.8,9,75,21,28.0,29,41,5,12,0,0,12,10,24,9
292,João Pedro,BRA,"MF,FW",Watford,20-032,2001,1.2,0,0,0,0,0,0,1,0.0,1,22,2,9.1,4,8,10,0,0,0,0,0,0,1
293,Nicolas Pépé,CIV,"FW,MF",Arsenal,26-152,1995,5.3,9,6,5,2,2,2,6,33.3,4,78,21,26.9,23,26,29,10,0,0,10,7,16,2
294,Ricardo Pereira,POR,DF,Leicester City,28-022,1993,5.6,19,10,8,9,2,10,22,45.5,12,106,29,27.4,37,49,20,15,2,0,13,11,30,16
295,Ayoze Pérez,ESP,"FW,MF",Leicester City,28-097,1993,1.5,3,2,0,3,0,0,2,0.0,2,33,9,27.3,7,21,5,2,0,0,2,2,5,0
296,Romain Perraud,FRA,DF,Southampton,24-036,1997,4.8,12,6,4,3,5,4,4,100.0,0,73,21,28.8,31,24,18,5,1,0,4,2,14,10
297,Kalvin Phillips,ENG,MF,Leeds United,25-330,1995,6.0,19,13,10,6,3,5,9,55.6,4,157,49,31.2,53,77,27,10,4,0,6,8,27,12
298,Jaden Philogene Bidace,ENG,FW,Aston Villa,19-163,2002,0.1,0,0,0,0,0,0,0,,0,2,0,0.0,1,1,0,0,0,0,0,0,0,0
299,Jordan Pickford,ENG,GK,Everton,27-235,1994,8.0,0,0,0,0,0,0,0,,0,0,0,,0,0,0,0,0,0,0,0,0,0
300,Erik Pieters,NED,"DF,MF",Burnley,33-082,1988,1.1,6,2,6,0,0,3,6,50.0,3,26,7,26.9,17,9,0,4,1,0,3,2,8,3
301,Ethan Pinnock,JAM,DF,Brentford,28-152,1993,8.0,10,8,8,2,0,2,7,28.6,5,56,19,33.9,38,18,0,10,3,0,7,18,28,44
302,Daniel Podence,POR,"FW,MF",Wolves,26-007,1995,1.7,1,0,1,0,0,0,2,0.0,2,18,6,33.3,5,3,10,1,0,0,1,0,1,0
303,Paul Pogba,FRA,"MF,FW",Manchester Utd,28-227,1993,7.0,10,3,5,4,1,3,10,30.0,7,134,39,29.1,28,67,39,8,1,0,7,12,22,12
304,Nick Pope,ENG,GK,Burnley,29-192,1992,9.0,0,0,0,0,0,0,1,0.0,1,0,0,,0,0,0,0,0,0,0,0,0,3
305,Teemu Pukki,FIN,FW,Norwich City,31-213,1990,8.4,4,2,0,2,2,0,4,0.0,4,167,35,21.0,20,77,70,5,0,0,5,5,9,1
306,Christian Pulisic,USA,MF,Chelsea,23-040,1998,0.9,0,0,0,0,0,0,2,0.0,2,28,7,25.0,4,9,15,0,0,0,0,1,1,0
307,Jesuran Rak Sakyi,ENG,MF,Crystal Palace,19-023,2002,0.2,0,0,0,0,0,0,0,,0,5,1,20.0,1,3,1,0,0,0,0,0,0,0
308,Aaron Ramsdale,ENG,GK,Arsenal,23-167,1998,6.0,0,0,0,0,0,0,0,,0,1,0,0.0,1,0,0,0,0,0,0,0,0,0
309,Jacob Ramsey,ENG,MF,Aston Villa,20-153,2001,5.3,10,5,5,5,0,3,14,21.4,11,114,34,29.8,28,54,32,8,2,0,6,8,18,6
310,Marcus Rashford,ENG,FW,Manchester Utd,23-362,1997,1.0,0,0,0,0,0,0,0,,0,7,2,28.6,1,4,2,1,0,0,1,0,0,0
311,Milot Rashica,KVX,"FW,MF",Norwich City,25-122,1996,5.1,6,5,2,3,1,4,7,57.1,3,74,19,25.7,27,23,24,5,1,0,4,10,16,2
312,David Raya,ESP,GK,Brentford,26-043,1995,9.0,0,0,0,0,0,0,0,,0,0,0,,0,0,0,0,0,0,0,0,0,0
313,Nathan Redmond,ENG,"MF,FW",Southampton,27-236,1994,6.1,4,3,1,3,0,1,10,10.0,9,113,28,24.8,17,44,52,11,0,0,11,7,11,4
314,Sergio Reguilón,ESP,DF,Tottenham,24-316,1996,8.9,18,8,10,6,2,9,16,56.3,7,127,28,22.0,57,48,22,16,4,0,12,23,41,28
315,Declan Rice,ENG,MF,West Ham,22-287,1999,9.0,21,16,11,7,3,3,10,30.0,7,118,40,33.9,52,57,9,20,10,1,10,27,48,10
316,Taylor Richards,ENG,MF,Brighton,20-328,2000,0.2,0,0,0,0,0,0,0,,0,7,3,42.9,5,2,0,0,0,0,0,0,0,0
317,Richarlison,BRA,"MF,FW",Everton,24-171,1997,4.2,7,2,2,2,3,2,4,50.0,2,71,22,31.0,16,25,30,10,2,0,8,2,9,8
318,Jaïro Riedewald,NED,MF,Crystal Palace,25-049,1996,1.1,1,1,0,1,0,1,2,50.0,1,9,3,33.3,6,2,1,2,0,0,2,0,1,2
319,Matt Ritchie,SCO,DF,Newcastle Utd,32-048,1989,9.0,17,6,9,6,2,9,18,50.0,9,101,31,30.7,46,42,13,20,1,0,19,10,27,20
320,Tyler Roberts,WAL,"MF,FW",Leeds United,22-289,1999,3.3,6,4,3,2,1,5,7,71.4,2,43,13,30.2,9,23,11,3,0,0,3,1,7,3
321,Andrew Robertson,SCO,DF,Liverpool,27-231,1994,5.6,7,4,3,3,1,3,6,50.0,3,51,10,19.6,14,23,14,11,3,1,8,12,19,19
322,Joe Rodon,WAL,DF,Tottenham,24-006,1997,0.9,0,0,0,0,0,0,0,,0,7,3,42.9,5,2,0,3,2,0,1,2,2,8
323,Rodri,ESP,MF,Manchester City,25-128,1996,7.0,15,12,6,8,1,11,17,64.7,6,78,32,41.0,20,45,13,8,1,1,7,11,26,19
324,Rodrigo,ESP,"FW,MF",Leeds United,30-236,1991,6.5,9,6,2,4,3,2,4,50.0,2,94,30,31.9,10,40,44,2,0,0,2,5,14,6
325,Jay Rodriguez,ENG,FW,Burnley,32-091,1989,2.1,4,2,1,2,1,0,3,0.0,3,40,8,20.0,3,21,16,2,1,0,1,0,4,0
326,Mads Roerslev,DEN,DF,Brentford,22-126,1999,0.5,4,1,4,0,0,3,5,60.0,2,12,2,16.7,9,2,1,2,0,0,2,0,4,2
327,Cristian Romero,ARG,DF,Tottenham,23-184,1998,3.9,12,7,5,7,0,6,10,60.0,4,55,23,41.8,37,18,0,11,5,0,6,17,29,17
328,Oriol Romeu,ESP,MF,Southampton,30-034,1991,8.4,25,15,7,15,3,6,21,28.6,15,141,46,32.6,49,69,23,12,4,0,8,12,37,19
329,Cristiano Ronaldo,POR,FW,Manchester Utd,36-265,1985,5.4,0,0,0,0,0,0,1,0.0,1,23,4,17.4,2,13,8,3,0,0,3,2,2,3
330,Salomón Rondón,VEN,FW,Everton,32-042,1989,4.8,4,1,0,1,3,1,8,12.5,7,86,22,25.6,8,41,37,3,0,0,3,0,4,6
331,Danny Rose,ENG,DF,Watford,31-118,1990,5.0,18,11,13,5,0,10,22,45.5,12,58,25,43.1,33,23,2,11,6,0,5,8,26,9
332,Antonio Rüdiger,GER,DF,Chelsea,28-239,1993,8.0,10,7,5,5,0,3,6,50.0,3,52,17,32.7,28,22,2,15,3,0,12,9,19,27
333,Lukas Rupp,GER,MF,Norwich City,30-293,1991,2.8,5,3,2,3,0,2,7,28.6,5,62,19,30.6,30,28,4,4,1,0,3,4,9,3
334,José Sá,POR,GK,Wolves,28-284,1993,9.0,0,0,0,0,0,0,0,,0,3,2,66.7,3,0,0,0,0,0,0,0,0,0
335,Allan Saint-Maximin,FRA,"FW,MF",Newcastle Utd,24-230,1997,8.9,3,3,2,0,1,0,4,0.0,4,58,23,39.7,10,23,25,4,0,0,4,4,7,0
336,Romain Saïss,MAR,DF,Wolves,31-216,1990,8.4,16,10,9,5,2,6,10,60.0,4,72,25,34.7,35,31,6,13,8,0,5,18,34,64
337,Bukayo Saka,ENG,"FW,MF",Arsenal,20-053,2001,7.0,6,3,1,5,0,2,8,25.0,6,82,17,20.7,20,31,31,9,0,0,9,6,12,2
338,Mohamed Salah,EGY,FW,Liverpool,29-135,1992,9.0,6,3,2,2,2,2,7,28.6,5,132,35,26.5,26,35,71,2,0,0,2,3,9,0
339,Mohammed Salisu,GHA,DF,Southampton,22-194,1999,8.6,22,18,17,3,2,11,16,68.8,5,83,36,43.4,49,28,6,20,11,1,9,27,49,51
340,Albert Sambi Lokonga,BEL,MF,Arsenal,22-006,1999,5.4,15,9,4,10,1,5,6,83.3,1,77,22,28.6,25,42,10,12,6,0,6,16,31,7
341,Davinson Sánchez,COL,DF,Tottenham,25-138,1996,4.1,8,3,5,3,0,3,6,50.0,3,39,14,35.9,20,16,3,11,8,0,3,4,12,27
342,Robert Sánchez,ESP,GK,Brighton,23-344,1997,9.0,0,0,0,0,0,0,0,,0,2,1,50.0,2,0,0,1,0,0,1,0,0,0
343,Jadon Sancho,ENG,FW,Manchester Utd,21-217,2000,3.3,2,1,0,2,0,1,2,50.0,1,48,16,33.3,12,22,14,4,1,0,3,3,5,1
344,Josh Sargent,USA,FW,Norwich City,21-250,2000,4.9,3,1,2,1,0,2,5,40.0,3,84,21,25.0,21,35,28,9,0,0,9,9,12,5
345,Ismaila Sarr,SEN,"MF,FW",Watford,23-245,1998,8.7,4,2,1,2,1,0,4,0.0,4,146,34,23.3,28,61,57,6,1,0,5,6,10,2
346,Malang Sarr,FRA,DF,Chelsea,22-278,1999,1.0,4,2,4,0,0,0,1,0.0,1,11,4,36.4,9,2,0,1,1,0,0,1,5,13
347,Fabian Schär,SUI,DF,Newcastle Utd,29-312,1991,2.0,3,2,3,0,0,2,2,100.0,0,12,6,50.0,9,2,1,2,1,0,1,4,7,10
348,Jeffrey Schlupp,GHA,"MF,FW",Crystal Palace,28-309,1992,1.9,2,0,1,1,0,0,1,0.0,1,17,5,29.4,5,8,4,1,0,0,1,2,4,1
349,Kasper Schmeichel,DEN,GK,Leicester City,34-357,1986,9.0,0,0,0,0,0,0,0,,0,0,0,,0,0,0,0,0,0,0,0,0,0
350,Ken Sema,SWE,"MF,FW",Watford,28-028,1993,2.7,4,3,4,0,0,0,5,0.0,5,60,12,20.0,21,35,4,3,0,0,3,1,5,7
351,Nélson Semedo,POR,DF,Wolves,27-346,1993,7.9,25,17,15,8,2,14,17,82.4,3,121,27,22.3,51,43,27,12,2,0,10,12,37,21
352,Jamie Shackleton,ENG,DF,Leeds United,22-020,1999,4.6,13,10,8,4,1,5,9,55.6,4,52,16,30.8,22,26,4,8,3,1,5,6,19,6
353,Luke Shaw,ENG,DF,Manchester Utd,26-108,1995,8.4,9,6,5,3,1,4,13,30.8,9,68,19,27.9,31,28,9,13,4,0,9,7,16,7
354,Jonjo Shelvey,ENG,MF,Newcastle Utd,29-243,1992,1.0,4,3,1,1,2,0,3,0.0,3,21,4,19.0,9,6,6,0,0,0,0,0,4,0
355,Francisco Sierralta,CHI,DF,Watford,24-175,1997,2.7,3,2,3,0,0,2,4,50.0,2,12,5,41.7,8,4,0,3,0,0,3,3,6,20
356,Bernardo Silva,POR,MF,Manchester City,27-079,1994,7.4,18,12,8,5,5,7,22,31.8,15,155,42,27.1,39,70,46,12,0,0,12,11,29,12
357,Fábio Silva,POR,"DF,FW",Wolves,19-101,2002,0.4,0,0,0,0,0,0,0,,0,7,3,42.9,1,4,2,0,0,0,0,0,0,0
358,Thiago Silva,BRA,DF,Chelsea,37-036,1984,5.2,8,4,4,4,0,4,9,44.4,5,40,10,25.0,23,15,2,19,11,1,8,15,23,31
359,Moussa Sissoko,FRA,MF,Watford,32-073,1989,6.8,11,5,6,4,1,3,4,75.0,1,98,25,25.5,33,53,12,13,2,0,11,8,19,15
360,Oliver Skipp,ENG,MF,Tottenham,21-042,2000,7.8,18,10,12,5,1,9,18,50.0,9,142,37,26.1,78,56,8,14,6,0,8,13,31,5
361,Emile Smith-Rowe,ENG,"MF,FW",Arsenal,21-092,2000,8.0,5,4,2,3,0,1,7,14.3,6,104,30,28.8,27,49,28,7,0,0,7,9,14,3
362,Cédric Soares,POR,DF,Arsenal,30-058,1991,2.1,3,2,1,1,1,2,3,66.7,1,24,6,25.0,11,8,5,4,2,0,2,4,7,6
363,Tomáš Souček,CZE,MF,West Ham,26-243,1995,8.9,26,15,14,9,3,9,23,39.1,14,129,45,34.9,50,61,18,17,1,0,16,10,36,35
364,Boubakary Soumaré,FRA,MF,Leicester City,22-243,1999,4.3,7,3,1,4,2,1,1,100.0,0,94,23,24.5,36,43,15,4,0,0,4,8,15,8
365,Çağlar Söyüncü,TUR,DF,Leicester City,25-158,1996,8.7,16,10,13,3,0,7,12,58.3,5,80,26,32.5,49,29,2,19,6,0,13,16,32,52
366,Jed Steer,ENG,GK,Aston Villa,29-035,1992,1.0,0,0,0,0,0,0,0,,0,0,0,,0,0,0,0,0,0,0,0,0,0
367,Zack Steffen,USA,GK,Manchester City,26-209,1995,1.0,0,0,0,0,0,0,0,,0,0,0,,0,0,0,0,0,0,0,0,0,0
368,Jack Stephens,ENG,DF,Southampton,27-274,1994,4.4,12,6,5,5,2,3,11,27.3,8,54,17,31.5,31,18,5,8,4,0,4,11,23,20
369,Raheem Sterling,ENG,FW,Manchester City,26-324,1994,4.1,5,2,0,3,2,2,9,22.2,7,60,13,21.7,5,38,17,1,0,0,1,2,7,0
370,John Stones,ENG,DF,Manchester City,27-153,1994,1.0,0,0,0,0,0,0,0,,0,3,2,66.7,0,3,0,1,0,0,1,0,0,4
371,Pascal Struijk,NED,"DF,MF",Leeds United,22-078,1999,5.3,15,12,7,8,0,3,6,50.0,3,88,33,37.5,38,44,6,12,5,0,7,18,33,26
372,Crysencio Summerville,NED,"MF,FW",Leeds United,19-363,2001,0.8,4,3,2,0,2,1,1,100.0,0,13,5,38.5,4,3,6,1,0,0,1,3,7,0
373,Japhet Tanganga,ENG,DF,Tottenham,22-211,1999,4.0,8,6,4,2,2,1,4,25.0,3,50,15,30.0,29,17,4,11,4,0,7,10,18,19
374,Matt Targett,ENG,DF,Aston Villa,26-040,1995,7.2,7,3,4,3,0,5,17,29.4,12,90,16,17.8,41,36,13,16,3,0,13,19,26,12
375,James Tarkowski,ENG,DF,Burnley,28-343,1992,9.0,15,7,10,4,1,7,9,77.8,2,66,25,37.9,44,19,3,20,14,1,6,18,33,43
376,Nuno Tavares,POR,DF,Arsenal,21-275,2000,1.6,4,3,1,1,2,0,2,0.0,2,28,6,21.4,12,10,6,6,1,0,5,3,7,6
377,Charlie Taylor,ENG,DF,Burnley,28-040,1993,8.0,17,5,11,6,0,11,16,68.8,5,53,14,26.4,29,19,5,32,5,0,27,19,36,27
378,Nathan Tella,ENG,"MF,FW",Southampton,22-115,1999,0.9,2,1,1,1,0,1,4,25.0,3,36,6,16.7,5,18,13,1,0,0,1,1,3,0
379,Luke Thomas,ENG,DF,Leicester City,20-140,2001,3.0,7,4,5,1,1,3,9,33.3,6,39,7,17.9,20,13,6,4,2,0,2,10,17,11
380,Youri Tielemans,BEL,MF,Leicester City,24-174,1997,9.0,16,12,7,7,2,8,23,34.8,15,145,43,29.7,48,69,28,20,8,0,12,6,22,17
381,Kieran Tierney,SCO,DF,Arsenal,24-145,1997,7.6,8,2,6,2,0,4,5,80.0,1,51,13,25.5,16,21,14,13,4,0,9,5,13,19
382,Takehiro Tomiyasu,JPN,DF,Arsenal,22-357,1998,5.7,10,2,5,2,3,5,8,62.5,3,71,15,21.1,24,34,13,15,0,0,15,9,19,22
383,James Tomkins,ENG,DF,Crystal Palace,32-213,1989,0.1,1,0,1,0,0,1,1,100.0,0,0,0,,0,0,0,0,0,0,0,0,1,0
384,Ivan Toney,ENG,FW,Brentford,25-226,1996,9.0,10,5,3,5,2,1,6,16.7,5,131,32,24.4,25,50,56,7,0,0,7,3,13,9
385,Ferrán Torres,ESP,FW,Manchester City,21-241,2000,3.4,1,1,0,1,0,0,1,0.0,1,40,13,32.5,4,9,27,6,1,0,5,1,2,0
386,Andros Townsend,ENG,"MF,FW",Everton,30-104,1991,7.8,18,11,9,7,2,4,21,19.0,17,156,52,33.3,55,63,38,21,1,0,20,13,31,4
387,Adama Traoré,ESP,"FW,MF",Wolves,25-276,1996,6.9,9,7,5,1,3,2,5,40.0,3,74,26,35.1,20,33,21,4,0,0,4,5,14,1
388,Bertrand Traoré,BFA,"MF,DF",Aston Villa,26-052,1995,0.6,1,0,0,0,1,0,1,0.0,1,9,3,33.3,1,2,6,0,0,0,0,0,1,0
389,Francisco Trincão,POR,"FW,MF",Wolves,21-303,1999,5.3,6,4,1,3,2,1,3,33.3,2,87,28,32.2,15,44,28,7,1,0,6,8,14,0
390,William Troost-Ekong,NGA,DF,Watford,28-057,1993,9.0,8,5,7,1,0,2,5,40.0,3,51,20,39.2,35,16,0,17,10,1,7,11,19,53
391,Leandro Trossard,BEL,"FW,MF",Brighton,26-328,1994,8.6,14,11,5,4,5,2,9,22.2,7,159,52,32.7,32,57,70,11,0,0,11,7,21,1
392,Kostas Tsimikas,GRE,DF,Liverpool,25-169,1996,3.3,9,4,5,0,4,4,8,50.0,4,53,14,26.4,20,13,20,6,1,0,5,5,14,12
393,Axel Tuanzebe,ENG,DF,Aston Villa,23-348,1997,4.5,5,4,4,1,0,2,4,50.0,2,41,12,29.3,17,20,4,5,4,0,1,8,13,11
394,Ozan Tufan,TUR,MF,Watford,26-219,1995,1.8,1,0,1,0,0,0,0,,0,36,3,8.3,12,18,6,1,0,0,1,0,1,3
395,Christos Tzolis,GRE,"FW,MF",Norwich City,19-271,2002,1.2,3,1,1,2,0,1,4,25.0,3,25,5,20.0,7,5,13,1,0,0,1,1,4,1
396,Raphaël Varane,FRA,DF,Manchester Utd,28-186,1993,5.0,6,4,2,2,2,2,4,50.0,2,38,17,44.7,25,10,3,11,4,0,7,11,17,35
397,Jamie Vardy,ENG,FW,Leicester City,34-290,1987,8.4,1,0,0,1,0,0,2,0.0,2,104,25,24.0,7,44,53,6,1,0,5,0,1,6
398,Joël Veltman,NED,DF,Brighton,29-286,1992,6.1,26,13,16,9,1,8,14,57.1,6,96,26,27.1,50,36,10,16,3,0,13,13,39,9
399,Jannik Vestergaard,DEN,DF,Leicester City,29-086,1992,4.3,11,8,10,1,0,6,13,46.2,7,45,21,46.7,34,11,0,12,8,0,4,13,24,33
400,Nikola Vlašić,CRO,MF,West Ham,24-024,1997,1.2,3,2,0,3,0,0,6,0.0,6,42,6,14.3,8,21,13,1,0,0,1,1,4,1
401,Matěj Vydra,CZE,FW,Burnley,29-180,1992,1.9,4,2,1,0,3,2,4,50.0,2,41,11,26.8,3,13,25,1,0,0,1,2,6,3
402,Theo Walcott,ENG,MF,Southampton,32-226,1989,2.8,4,2,1,1,2,2,4,50.0,2,55,11,20.0,10,25,20,4,0,0,4,2,6,0
403,Kyle Walker,ENG,DF,Manchester City,31-153,1990,6.5,7,5,4,2,1,3,9,33.3,6,57,16,28.1,17,30,10,9,4,0,5,6,13,9
404,Kyle Walker-Peters,ENG,DF,Southampton,24-198,1997,3.9,8,4,5,3,0,4,10,40.0,6,44,16,36.4,18,20,6,7,0,0,7,9,17,6
405,Aaron Wan-Bissaka,ENG,DF,Manchester Utd,23-336,1997,9.0,17,10,8,6,3,2,7,28.6,5,94,29,30.9,36,37,21,21,5,1,16,14,31,20
406,Joel Ward,ENG,DF,Crystal Palace,31-364,1989,9.0,16,8,11,5,0,11,18,61.1,7,91,28,30.8,47,30,14,22,4,0,18,10,26,34
407,James Ward-Prowse,ENG,MF,Southampton,26-361,1994,6.8,10,6,4,3,3,1,18,5.6,17,123,35,28.5,38,66,19,14,3,1,11,11,21,5
408,Ollie Watkins,ENG,FW,Aston Villa,25-302,1995,6.1,1,1,0,1,0,0,2,0.0,2,83,28,33.7,4,35,44,9,0,0,9,3,4,3
409,Adam Webster,ENG,DF,Brighton,26-297,1995,3.4,12,4,9,2,1,6,8,75.0,2,36,12,33.3,25,8,3,8,4,0,4,6,18,14
410,Danny Welbeck,ENG,"FW,MF",Brighton,30-336,1990,2.7,3,2,0,2,1,0,1,0.0,1,49,12,24.5,11,22,16,5,0,0,5,0,3,1
411,Timo Werner,GER,FW,Chelsea,25-236,1996,4.3,1,0,0,0,1,0,10,0.0,10,97,24,24.7,15,31,51,4,0,0,4,2,3,2
412,Ashley Westwood,ENG,MF,Burnley,31-210,1990,8.0,11,9,3,7,1,3,8,37.5,5,124,28,22.6,39,66,19,5,2,0,3,14,25,9
413,Ben White,ENG,DF,Arsenal,24-020,1997,7.0,6,4,5,1,0,3,5,60.0,2,36,12,33.3,22,14,0,9,4,0,5,19,25,22
